File,run,time,seconds,packet_count,length,consumer_packets,total_packets,location_consumer_packets,consumer_lag,count,location_consumer_lag,multi
multi_pi-10-7500.csv,3,1687891466180,0.0,0,47,0,8082151,0,0,10,0,1
multi_pi-10-7500.csv,3,1687891466681,0.5,6100,5450,830,8088251,770,5270,10,5330,1
multi_pi-10-7500.csv,3,1687891467197,1.0,13350,11690,1760,8095501,1760,11590,10,11590,1
multi_pi-10-7500.csv,3,1687891467695,1.5,19250,16951,2400,8101401,2550,16850,10,16700,1
multi_pi-10-7500.csv,3,1687891468187,2.0,27600,24443,3290,8109751,3330,24310,10,24270,1
multi_pi-10-7500.csv,3,1687891468689,2.5,35450,31395,4190,8117601,4270,31260,10,31180,1
multi_pi-10-7500.csv,3,1687891469183,3.0,43450,38477,5150,8125601,5070,38300,10,38380,1
multi_pi-10-7500.csv,3,1687891469681,3.5,50600,44795,6110,8132751,5920,44490,10,44680,1
multi_pi-10-7500.csv,3,1687891470182,4.0,62500,55850,6760,8144651,6870,55740,10,55630,1
multi_pi-10-7500.csv,3,1687891470685,4.5,69300,61728,7670,8151451,7750,61630,10,61550,1
multi_pi-10-7500.csv,3,1687891471184,5.0,76800,68377,8620,8158951,8530,68180,10,68270,1
multi_pi-10-7500.csv,3,1687891471702,5.5,84350,75017,9580,8166501,9470,74770,10,74880,1
multi_pi-10-7500.csv,3,1687891472188,6.0,91900,81629,10380,8174051,10490,81520,10,81410,1
multi_pi-10-7500.csv,3,1687891472700,6.5,98700,87537,11290,8180851,11450,87410,10,87250,1
multi_pi-10-7500.csv,3,1687891473182,7.0,100000,87900,12210,8182151,12390,87790,10,87610,1
multi_pi-10-7500.csv,3,1687891473680,7.5,100000,86900,13160,8182151,13350,86840,10,86650,1
multi_pi-10-7500.csv,3,1687891474185,8.0,100000,86050,14050,8182151,14510,85950,10,85490,1
multi_pi-10-7500.csv,3,1687891474683,8.5,100000,85346,14870,8182151,15430,85130,10,84570,1
multi_pi-10-7500.csv,3,1687891475182,9.0,100000,84698,15460,8182151,16210,84540,10,83790,1
multi_pi-10-7500.csv,3,1687891475681,9.5,100000,83950,16170,8182151,17180,83830,10,82820,1
multi_pi-10-7500.csv,3,1687891476182,10.0,100000,83041,17060,8182151,18240,82940,10,81760,1
multi_pi-10-7500.csv,3,1687891476687,10.5,100000,82000,18110,8182151,19140,81890,10,80860,1
multi_pi-10-7500.csv,3,1687891477203,11.0,100000,81000,19120,8182151,20170,80880,10,79830,1
multi_pi-10-7500.csv,3,1687891477684,11.5,100000,80050,20040,8182151,20770,79960,10,79230,1
multi_pi-10-7500.csv,3,1687891478191,12.0,100000,78950,21160,8182151,21590,78840,10,78410,1
multi_pi-10-7500.csv,3,1687891478687,12.5,100000,78086,22020,8182151,22650,77980,10,77350,1
multi_pi-10-7500.csv,3,1687891479189,13.0,100000,77150,22960,8182151,23660,77040,10,76340,1
multi_pi-10-7500.csv,3,1687891479690,13.5,100000,76450,23680,8182151,24880,76320,10,75120,1
multi_pi-10-7500.csv,3,1687891480187,14.0,100000,75600,24520,8182151,26020,75480,10,73980,1
multi_pi-10-7500.csv,3,1687891480682,14.5,100000,74678,25450,8182151,26980,74550,10,73020,1
multi_pi-10-7500.csv,3,1687891481189,15.0,100000,73650,26470,8182151,27960,73530,10,72040,1
multi_pi-10-7500.csv,3,1687891481686,15.5,100000,72700,27430,8182151,28990,72570,10,71010,1
multi_pi-10-7500.csv,3,1687891482186,16.0,100000,71624,28480,8182151,30000,71520,10,70000,1
multi_pi-10-7500.csv,3,1687891482685,16.5,100000,70798,29340,8182151,30760,70660,10,69240,1
multi_pi-10-7500.csv,3,1687891483188,17.0,100000,69850,30260,8182151,31500,69740,10,68500,1
multi_pi-10-7500.csv,3,1687891483686,17.5,100000,68949,31120,8182151,32490,68880,10,67510,1
multi_pi-10-7500.csv,3,1687891484186,18.0,100000,68336,31790,8182151,33550,68210,10,66450,1
multi_pi-10-7500.csv,3,1687891484686,18.5,100000,67450,32620,8182151,34500,67380,10,65500,1
multi_pi-10-7500.csv,3,1687891485185,19.0,100000,66517,33600,8182151,35510,66400,10,64490,1
multi_pi-10-7500.csv,3,1687891485684,19.5,100000,65400,34670,8182151,36380,65330,10,63620,1
multi_pi-10-7500.csv,3,1687891486187,20.0,100000,64349,35750,8182151,37270,64250,10,62730,1
multi_pi-10-7500.csv,3,1687891486699,20.5,100000,63200,36890,8182151,38130,63110,10,61870,1
multi_pi-10-7500.csv,3,1687891487194,21.0,100000,62150,37960,8182151,39080,62040,10,60920,1
multi_pi-10-7500.csv,3,1687891487690,21.5,100000,61296,38770,8182151,40110,61230,10,59890,1
multi_pi-10-7500.csv,3,1687891488201,22.0,100000,60350,39760,8182151,41170,60240,10,58830,1
multi_pi-10-7500.csv,3,1687891488690,22.5,100000,59430,40650,8182151,41770,59350,10,58230,1
multi_pi-10-7500.csv,3,1687891489190,23.0,100000,58280,41850,8182151,42520,58150,10,57480,1
multi_pi-10-7500.csv,3,1687891489696,23.5,100000,57200,42930,8182151,43470,57070,10,56530,1
multi_pi-10-7500.csv,3,1687891490193,24.0,100000,56441,43700,8182151,44430,56300,10,55570,1
multi_pi-10-7500.csv,3,1687891490694,24.5,100000,55567,44550,8182151,45230,55450,10,54770,1
multi_pi-10-7500.csv,3,1687891491205,25.0,100000,54400,45740,8182151,46300,54260,10,53700,1
multi_pi-10-7500.csv,3,1687891491703,25.5,100000,53350,46780,8182151,47400,53220,10,52600,1
multi_pi-10-7500.csv,3,1687891492192,26.0,100000,52275,47810,8182151,48360,52190,10,51640,1
multi_pi-10-7500.csv,3,1687891492692,26.5,100000,51150,48960,8182151,49290,51040,10,50710,1
multi_pi-10-7500.csv,3,1687891493193,27.0,100000,50100,50040,8182151,50210,49960,10,49790,1
multi_pi-10-7500.csv,3,1687891493696,27.5,100000,49038,51080,8182151,51140,48920,10,48860,1
multi_pi-10-7500.csv,3,1687891494200,28.0,100000,48150,51940,8182151,52320,48060,10,47680,1
multi_pi-10-7500.csv,3,1687891494692,28.5,100000,47050,53070,8182151,53120,46930,10,46880,1
multi_pi-10-7500.csv,3,1687891495206,29.0,100000,46050,54070,8182151,54130,45930,10,45870,1
multi_pi-10-7500.csv,3,1687891495693,29.5,100000,45049,55070,8182151,55080,44930,10,44920,1
multi_pi-10-7500.csv,3,1687891496196,30.0,100000,44050,56050,8182151,56070,43950,10,43930,1
multi_pi-10-7500.csv,3,1687891496695,30.5,100000,43250,56830,8182151,57270,43170,10,42730,1
multi_pi-10-7500.csv,3,1687891497195,31.0,100000,42950,57330,8182151,58310,42670,10,41690,1
multi_pi-10-7500.csv,3,1687891497695,31.5,100000,42028,58070,8182151,59250,41930,10,40750,1
multi_pi-10-7500.csv,3,1687891498196,32.0,100000,41250,58870,8182151,60080,41130,10,39920,1
multi_pi-10-7500.csv,3,1687891498695,32.5,100000,40297,59840,8182151,61090,40160,10,38910,1
multi_pi-10-7500.csv,3,1687891499196,33.0,100000,39291,60810,8182151,62040,39190,10,37960,1
multi_pi-10-7500.csv,3,1687891499697,33.5,100000,38045,62070,8182151,62750,37930,10,37250,1
multi_pi-10-7500.csv,3,1687891500198,34.0,100000,37000,63130,8182151,63690,36870,10,36310,1
multi_pi-10-7500.csv,3,1687891500695,34.5,100000,36250,63890,8182151,64850,36110,10,35150,1
multi_pi-10-7500.csv,3,1687891501196,35.0,100000,35378,64710,8182151,66010,35290,10,33990,1
multi_pi-10-7500.csv,3,1687891501701,35.5,100000,34450,65680,8182151,66970,34320,10,33030,1
multi_pi-10-7500.csv,3,1687891502209,36.0,100000,33500,66710,8182151,67980,33290,10,32020,1
multi_pi-10-7500.csv,3,1687891502700,36.5,100000,32430,67660,8182151,69020,32340,10,30980,1
multi_pi-10-7500.csv,3,1687891503205,37.0,100000,31450,68680,8182151,70080,31320,10,29920,1
multi_pi-10-7500.csv,3,1687891503703,37.5,100000,30341,69750,8182151,71220,30250,10,28780,1
multi_pi-10-7500.csv,3,1687891504197,38.0,100000,29100,70990,8182151,72090,29010,10,27910,1
multi_pi-10-7500.csv,3,1687891504697,38.5,100000,28167,71920,8182151,73140,28080,10,26860,1
multi_pi-10-7500.csv,3,1687891505206,39.0,100000,27350,72760,8182151,74110,27240,10,25890,1
multi_pi-10-7500.csv,3,1687891505700,39.5,100000,26749,73420,8182151,74750,26580,10,25250,1
multi_pi-10-7500.csv,3,1687891506209,40.0,100000,25646,74470,8182151,75740,25530,10,24260,1
multi_pi-10-7500.csv,3,1687891506700,40.5,100000,24550,75570,8182151,76630,24430,10,23370,1
multi_pi-10-7500.csv,3,1687891507203,41.0,100000,23600,76530,8182151,77620,23470,10,22380,1
multi_pi-10-7500.csv,3,1687891507700,41.5,100000,22650,77440,8182151,78810,22560,10,21190,1
multi_pi-10-7500.csv,3,1687891508201,42.0,100000,21500,78610,8182151,79650,21390,10,20350,1
multi_pi-10-7500.csv,3,1687891508699,42.5,100000,20448,79650,8182151,80640,20350,10,19360,1
multi_pi-10-7500.csv,3,1687891509200,43.0,100000,19446,80630,8182151,81720,19370,10,18280,1
multi_pi-10-7500.csv,3,1687891509700,43.5,100000,18536,81580,8182151,82780,18420,10,17220,1
multi_pi-10-7500.csv,3,1687891510205,44.0,100000,17550,82560,8182151,83760,17440,10,16240,1
multi_pi-10-7500.csv,3,1687891510701,44.5,100000,16750,83360,8182151,84940,16640,10,15060,1
multi_pi-10-7500.csv,3,1687891511202,45.0,100000,15747,84350,8182151,85950,15650,10,14050,1
multi_pi-10-7500.csv,3,1687891511702,45.5,100000,15050,85100,8182151,87260,14900,10,12740,1
multi_pi-10-7500.csv,3,1687891512209,46.0,100000,14000,86150,8182151,88220,13850,10,11780,1
multi_pi-10-7500.csv,3,1687891512705,46.5,100000,13199,86930,8182151,88980,13070,10,11020,1
multi_pi-10-7500.csv,3,1687891513213,47.0,100000,12127,88000,8182151,89780,12000,10,10220,1
multi_pi-10-7500.csv,3,1687891513702,47.5,100000,11100,89000,8182151,90820,11000,10,9180,1
multi_pi-10-7500.csv,3,1687891514203,48.0,100000,10350,89790,8182151,91880,10210,10,8120,1
multi_pi-10-7500.csv,3,1687891514702,48.5,100000,9643,90480,8182151,92850,9520,10,7150,1
multi_pi-10-7500.csv,3,1687891515212,49.0,100000,8550,91560,8182151,93890,8440,10,6110,1
multi_pi-10-7500.csv,3,1687891515704,49.5,100000,7500,92620,8182151,94860,7380,10,5140,1
multi_pi-10-7500.csv,3,1687891516203,50.0,100000,6449,93680,8182151,95830,6320,10,4170,1
multi_pi-10-7500.csv,3,1687891516714,50.5,100000,5399,94730,8182151,96860,5270,10,3140,1
multi_pi-10-7500.csv,3,1687891517204,51.0,100000,4450,95640,8182151,97770,4360,10,2230,1
multi_pi-10-7500.csv,3,1687891517703,51.5,100000,3645,96450,8182151,98860,3550,10,1140,1
multi_pi-10-7500.csv,3,1687891518204,52.0,100000,2987,97130,8182151,100000,2870,10,0,1
multi_pi-10-7500.csv,3,1687891518705,52.5,100000,2137,97970,8182151,100000,2030,10,0,1
multi_pi-10-7500.csv,3,1687891519204,53.0,100000,997,99070,8182151,100000,930,10,0,1
multi_pi-10-7500.csv,3,1687891519704,53.5,100000,195,99900,8182151,100000,100,10,0,1
multi_pi-10-7500.csv,3,1687891520205,54.0,100000,50,100000,8182151,100000,0,10,0,1
multi_pi-10-7500.csv,2,1687891388133,0.0,0,50,0,7982151,0,0,10,0,1
multi_pi-10-7500.csv,2,1687891388637,0.5,6850,6194,970,7989001,730,5880,10,6120,1
multi_pi-10-7500.csv,2,1687891389165,1.0,14150,12831,1980,7996301,1440,12170,10,12710,1
multi_pi-10-7500.csv,2,1687891389652,1.5,22450,20700,3000,8004601,1880,19450,10,20570,1
multi_pi-10-7500.csv,2,1687891390175,2.0,29950,27381,3840,8012101,2700,26110,10,27250,1
multi_pi-10-7500.csv,2,1687891390644,2.5,37850,34595,4710,8020001,3360,33140,10,34490,1
multi_pi-10-7500.csv,2,1687891391144,3.0,47850,44100,5620,8030001,3920,42230,10,43930,1
multi_pi-10-7500.csv,2,1687891391644,3.5,57950,53522,6600,8040101,4510,51350,10,53440,1
multi_pi-10-7500.csv,2,1687891392159,4.0,66250,61050,7580,8048401,5290,58670,10,60960,1
multi_pi-10-7500.csv,2,1687891392650,4.5,72100,66192,8210,8054251,5980,63890,10,66120,1
multi_pi-10-7500.csv,2,1687891393152,5.0,78450,71891,9150,8060601,6690,69300,10,71760,1
multi_pi-10-7500.csv,2,1687891393648,5.5,83350,76050,10240,8065501,7420,73110,10,75930,1
multi_pi-10-7500.csv,2,1687891394145,6.0,89650,81591,10780,8071801,8160,78870,10,81490,1
multi_pi-10-7500.csv,2,1687891394655,6.5,98300,89477,11620,8080451,8930,86680,10,89370,1
multi_pi-10-7500.csv,2,1687891395147,7.0,100000,90350,12550,8082151,9790,87450,10,90210,1
multi_pi-10-7500.csv,2,1687891395646,7.5,100000,89699,13860,8082151,10450,86140,10,89550,1
multi_pi-10-7500.csv,2,1687891396144,8.0,100000,88891,14970,8082151,11220,85030,10,88780,1
multi_pi-10-7500.csv,2,1687891396651,8.5,100000,88088,16070,8082151,12020,83930,10,87980,1
multi_pi-10-7500.csv,2,1687891397149,9.0,100000,87250,17200,8082151,12850,82800,10,87150,1
multi_pi-10-7500.csv,2,1687891397646,9.5,100000,86250,18170,8082151,13840,81830,10,86160,1
multi_pi-10-7500.csv,2,1687891398148,10.0,100000,85350,19150,8082151,14780,80850,10,85220,1
multi_pi-10-7500.csv,2,1687891398646,10.5,100000,84448,20200,8082151,15690,79800,10,84310,1
multi_pi-10-7500.csv,2,1687891399144,11.0,100000,83976,21290,8082151,16240,78710,10,83760,1
multi_pi-10-7500.csv,2,1687891399649,11.5,100000,83200,22370,8082151,16930,77630,10,83070,1
multi_pi-10-7500.csv,2,1687891400148,12.0,100000,82521,23330,8082151,17560,76670,10,82440,1
multi_pi-10-7500.csv,2,1687891400645,12.5,100000,81750,24240,8082151,18340,75760,10,81660,1
multi_pi-10-7500.csv,2,1687891401146,13.0,100000,81195,25190,8082151,18900,74810,10,81100,1
multi_pi-10-7500.csv,2,1687891401647,13.5,100000,80300,26170,8082151,19800,73830,10,80200,1
multi_pi-10-7500.csv,2,1687891402149,14.0,100000,79400,27150,8082151,20690,72850,10,79310,1
multi_pi-10-7500.csv,2,1687891402646,14.5,100000,78335,27960,8082151,21760,72040,10,78240,1
multi_pi-10-7500.csv,2,1687891403150,15.0,100000,77149,28760,8082151,22990,71240,10,77010,1
multi_pi-10-7500.csv,2,1687891403647,15.5,100000,76250,29810,8082151,23850,70190,10,76150,1
multi_pi-10-7500.csv,2,1687891404153,16.0,100000,75300,30870,8082151,24800,69130,10,75200,1
multi_pi-10-7500.csv,2,1687891404646,16.5,100000,74345,31870,8082151,25740,68130,10,74260,1
multi_pi-10-7500.csv,2,1687891405148,17.0,100000,73296,32690,8082151,26830,67310,10,73170,1
multi_pi-10-7500.csv,2,1687891405648,17.5,100000,72200,33510,8082151,27900,66490,10,72100,1
multi_pi-10-7500.csv,2,1687891406150,18.0,100000,71139,34370,8082151,28970,65630,10,71030,1
multi_pi-10-7500.csv,2,1687891406653,18.5,100000,69978,35380,8082151,30120,64620,10,69880,1
multi_pi-10-7500.csv,2,1687891407149,19.0,100000,68896,36310,8082151,31180,63690,10,68820,1
multi_pi-10-7500.csv,2,1687891407649,19.5,100000,68000,36950,8082151,32120,63050,10,67880,1
multi_pi-10-7500.csv,2,1687891408148,20.0,100000,67099,37770,8082151,33000,62230,10,67000,1
multi_pi-10-7500.csv,2,1687891408649,20.5,100000,66150,38710,8082151,33950,61290,10,66050,1
multi_pi-10-7500.csv,2,1687891409149,21.0,100000,65167,39640,8082151,34900,60360,10,65100,1
multi_pi-10-7500.csv,2,1687891409656,21.5,100000,64291,40680,8082151,35900,59320,10,64100,1
multi_pi-10-7500.csv,2,1687891410153,22.0,100000,63150,41700,8082151,36960,58300,10,63040,1
multi_pi-10-7500.csv,2,1687891410672,22.5,100000,62100,42850,8082151,38050,57150,10,61950,1
multi_pi-10-7500.csv,2,1687891411150,23.0,100000,61034,43830,8082151,39070,56170,10,60930,1
multi_pi-10-7500.csv,2,1687891411651,23.5,100000,60000,44770,8082151,40100,55230,10,59900,1
multi_pi-10-7500.csv,2,1687891412150,24.0,100000,59050,45750,8082151,41040,54250,10,58960,1
multi_pi-10-7500.csv,2,1687891412650,24.5,100000,58096,46700,8082151,42010,53300,10,57990,1
multi_pi-10-7500.csv,2,1687891413151,25.0,100000,57096,47640,8082151,43000,52360,10,57000,1
multi_pi-10-7500.csv,2,1687891413651,25.5,100000,56150,48570,8082151,43940,51430,10,56060,1
multi_pi-10-7500.csv,2,1687891414156,26.0,100000,55200,49570,8082151,44900,50430,10,55100,1
multi_pi-10-7500.csv,2,1687891414653,26.5,100000,54300,50640,8082151,45780,49360,10,54220,1
multi_pi-10-7500.csv,2,1687891415154,27.0,100000,53550,51510,8082151,46540,48490,10,53460,1
multi_pi-10-7500.csv,2,1687891415652,27.5,100000,52750,52470,8082151,47330,47530,10,52670,1
multi_pi-10-7500.csv,2,1687891416153,28.0,100000,51739,53490,8082151,48330,46510,10,51670,1
multi_pi-10-7500.csv,2,1687891416653,28.5,100000,50841,54550,8082151,49240,45450,10,50760,1
multi_pi-10-7500.csv,2,1687891417153,29.0,100000,49950,55710,8082151,50110,44290,10,49890,1
multi_pi-10-7500.csv,2,1687891417653,29.5,100000,48950,56650,8082151,51170,43350,10,48830,1
multi_pi-10-7500.csv,2,1687891418154,30.0,100000,47919,57590,8082151,52170,42410,10,47830,1
multi_pi-10-7500.csv,2,1687891418654,30.5,100000,46933,58500,8082151,53170,41500,10,46830,1
multi_pi-10-7500.csv,2,1687891419155,31.0,100000,46050,59500,8082151,54080,40500,10,45920,1
multi_pi-10-7500.csv,2,1687891419658,31.5,100000,45096,60470,8082151,55070,39530,10,44930,1
multi_pi-10-7500.csv,2,1687891420155,32.0,100000,44047,61480,8082151,56030,38520,10,43970,1
multi_pi-10-7500.csv,2,1687891420657,32.5,100000,43096,62530,8082151,56990,37470,10,43010,1
multi_pi-10-7500.csv,2,1687891421156,33.0,100000,42150,63590,8082151,57920,36410,10,42080,1
multi_pi-10-7500.csv,2,1687891421656,33.5,100000,41350,64730,8082151,58760,35270,10,41240,1
multi_pi-10-7500.csv,2,1687891422154,34.0,100000,40250,65670,8082151,59870,34330,10,40130,1
multi_pi-10-7500.csv,2,1687891422655,34.5,100000,39550,66600,8082151,60560,33400,10,39440,1
multi_pi-10-7500.csv,2,1687891423154,35.0,100000,38544,67350,8082151,61530,32650,10,38470,1
multi_pi-10-7500.csv,2,1687891423654,35.5,100000,37450,68190,8082151,62660,31810,10,37340,1
multi_pi-10-7500.csv,2,1687891424156,36.0,100000,36499,69250,8082151,63600,30750,10,36400,1
multi_pi-10-7500.csv,2,1687891424666,36.5,100000,35455,70360,8082151,64640,29640,10,35360,1
multi_pi-10-7500.csv,2,1687891425154,37.0,100000,34350,71390,8082151,65750,28610,10,34250,1
multi_pi-10-7500.csv,2,1687891425655,37.5,100000,33350,72450,8082151,66730,27550,10,33270,1
multi_pi-10-7500.csv,2,1687891426157,38.0,100000,32273,73330,8082151,67860,26670,10,32140,1
multi_pi-10-7500.csv,2,1687891426655,38.5,100000,31300,74440,8082151,68760,25560,10,31240,1
multi_pi-10-7500.csv,2,1687891427155,39.0,100000,30350,75480,8082151,69770,24520,10,30230,1
multi_pi-10-7500.csv,2,1687891427656,39.5,100000,29449,76560,8082151,70650,23440,10,29350,1
multi_pi-10-7500.csv,2,1687891428163,40.0,100000,28550,77660,8082151,71590,22340,10,28410,1
multi_pi-10-7500.csv,2,1687891428665,40.5,100000,27472,78640,8082151,72670,21360,10,27330,1
multi_pi-10-7500.csv,2,1687891429155,41.0,100000,26541,79750,8082151,73540,20250,10,26460,1
multi_pi-10-7500.csv,2,1687891429664,41.5,100000,25617,80810,8082151,74500,19190,10,25500,1
multi_pi-10-7500.csv,2,1687891430157,42.0,100000,24642,81530,8082151,75430,18470,10,24570,1
multi_pi-10-7500.csv,2,1687891430656,42.5,100000,23700,82250,8082151,76420,17750,10,23580,1
multi_pi-10-7500.csv,2,1687891431169,43.0,100000,22800,83380,8082151,77370,16620,10,22630,1
multi_pi-10-7500.csv,2,1687891431659,43.5,100000,21500,84200,8082151,78630,15800,10,21370,1
multi_pi-10-7500.csv,2,1687891432163,44.0,100000,20550,85250,8082151,79580,14750,10,20420,1
multi_pi-10-7500.csv,2,1687891432660,44.5,100000,19596,86340,8082151,80500,13660,10,19500,1
multi_pi-10-7500.csv,2,1687891433159,45.0,100000,18641,87340,8082151,81420,12660,10,18580,1
multi_pi-10-7500.csv,2,1687891433665,45.5,100000,18100,88390,8082151,82090,11610,10,17910,1
multi_pi-10-7500.csv,2,1687891434160,46.0,100000,17096,89380,8082151,83000,10620,10,17000,1
multi_pi-10-7500.csv,2,1687891434660,46.5,100000,16250,90410,8082151,83860,9590,10,16140,1
multi_pi-10-7500.csv,2,1687891435160,47.0,100000,15300,91490,8082151,84800,8510,10,15200,1
multi_pi-10-7500.csv,2,1687891435661,47.5,100000,14469,92690,8082151,85610,7310,10,14390,1
multi_pi-10-7500.csv,2,1687891436178,48.0,100000,13500,93710,8082151,86610,6290,10,13390,1
multi_pi-10-7500.csv,2,1687891436659,48.5,100000,12397,94600,8082151,87680,5400,10,12320,1
multi_pi-10-7500.csv,2,1687891437160,49.0,100000,11396,95600,8082151,88700,4400,10,11300,1
multi_pi-10-7500.csv,2,1687891437662,49.5,100000,10600,96510,8082151,89480,3490,10,10520,1
multi_pi-10-7500.csv,2,1687891438161,50.0,100000,9825,97430,8082151,90260,2570,10,9740,1
multi_pi-10-7500.csv,2,1687891438662,50.5,100000,8992,98470,8082151,91140,1530,10,8860,1
multi_pi-10-7500.csv,2,1687891439162,51.0,100000,7850,99420,8082151,92210,580,10,7790,1
multi_pi-10-7500.csv,2,1687891439665,51.5,100000,6900,100000,8082151,93190,0,10,6810,1
multi_pi-10-7500.csv,2,1687891440164,52.0,100000,5900,100000,8082151,94210,0,10,5790,1
multi_pi-10-7500.csv,2,1687891440668,52.5,100000,4863,100000,8082151,95240,0,10,4760,1
multi_pi-10-7500.csv,2,1687891441169,53.0,100000,3850,100000,8082151,96260,0,10,3740,1
multi_pi-10-7500.csv,2,1687891441667,53.5,100000,2781,100000,8082151,97310,0,10,2690,1
multi_pi-10-7500.csv,2,1687891442165,54.0,100000,1849,100000,8082151,98280,0,10,1720,1
multi_pi-10-7500.csv,2,1687891442665,54.5,100000,915,100000,8082151,99200,0,10,800,1
multi_pi-10-7500.csv,2,1687891443169,55.0,100000,47,100000,8082151,100000,0,10,0,1
multi_pi-10-7500.csv,1,1687891320598,0.0,0,149,0,7882151,0,0,10,0,1
multi_pi-10-7500.csv,1,1687891321107,0.5,8150,8176,240,7890301,340,7910,10,7810,1
multi_pi-10-7500.csv,1,1687891321608,1.0,12500,11921,670,7894651,780,11830,10,11720,1
multi_pi-10-7500.csv,1,1687891322104,1.5,18350,17300,1140,7900501,1160,17210,10,17190,1
multi_pi-10-7500.csv,1,1687891322601,2.0,25650,24150,1560,7907801,1630,24090,10,24020,1
multi_pi-10-7500.csv,1,1687891323101,2.5,33150,31247,2000,7915301,2070,31150,10,31080,1
multi_pi-10-7500.csv,1,1687891323598,3.0,42650,40300,2440,7924801,2470,40210,10,40180,1
multi_pi-10-7500.csv,1,1687891324099,3.5,49650,46900,2910,7931801,2960,46740,10,46690,1
multi_pi-10-7500.csv,1,1687891324605,4.0,57800,54596,3330,7939951,3340,54470,10,54460,1
multi_pi-10-7500.csv,1,1687891325100,4.5,67100,63500,3720,7949251,3710,63380,10,63390,1
multi_pi-10-7500.csv,1,1687891325616,5.0,72200,68233,4220,7954351,4120,67980,10,68080,1
multi_pi-10-7500.csv,1,1687891326103,5.5,78700,74150,4710,7960851,4790,73990,10,73910,1
multi_pi-10-7500.csv,1,1687891326600,6.0,86600,81445,5270,7968751,5310,81330,10,81290,1
multi_pi-10-7500.csv,1,1687891327106,6.5,94750,89200,5700,7976901,5960,89050,10,88790,1
multi_pi-10-7500.csv,1,1687891327599,7.0,100000,93932,6190,7982151,6590,93810,10,93410,1
multi_pi-10-7500.csv,1,1687891328117,7.5,100000,93247,6840,7982151,7310,93160,10,92690,1
multi_pi-10-7500.csv,1,1687891328601,8.0,100000,92550,7550,7982151,7890,92450,10,92110,1
multi_pi-10-7500.csv,1,1687891329098,8.5,100000,91943,8160,7982151,8500,91840,10,91500,1
multi_pi-10-7500.csv,1,1687891329598,9.0,100000,91250,8840,7982151,9180,91160,10,90820,1
multi_pi-10-7500.csv,1,1687891330100,9.5,100000,90547,9540,7982151,9880,90460,10,90120,1
multi_pi-10-7500.csv,1,1687891330598,10.0,100000,89800,10280,7982151,10460,89720,10,89540,1
multi_pi-10-7500.csv,1,1687891331100,10.5,100000,88950,11160,7982151,11170,88840,10,88830,1
multi_pi-10-7500.csv,1,1687891331601,11.0,100000,88250,11880,7982151,11930,88120,10,88070,1
multi_pi-10-7500.csv,1,1687891332098,11.5,100000,87400,12760,7982151,12700,87240,10,87300,1
multi_pi-10-7500.csv,1,1687891332600,12.0,100000,86728,13520,7982151,13380,86480,10,86620,1
multi_pi-10-7500.csv,1,1687891333103,12.5,100000,86100,14280,7982151,14050,85720,10,85950,1
multi_pi-10-7500.csv,1,1687891333601,13.0,100000,85200,15040,7982151,14940,84960,10,85060,1
multi_pi-10-7500.csv,1,1687891334101,13.5,100000,84300,16040,7982151,15840,83960,10,84160,1
multi_pi-10-7500.csv,1,1687891334599,14.0,100000,83465,17070,7982151,16610,82930,10,83390,1
multi_pi-10-7500.csv,1,1687891335100,14.5,100000,82635,17920,7982151,17480,82080,10,82520,1
multi_pi-10-7500.csv,1,1687891335598,15.0,100000,81800,18890,7982151,18260,81110,10,81740,1
multi_pi-10-7500.csv,1,1687891336100,15.5,100000,80941,19780,7982151,19140,80220,10,80860,1
multi_pi-10-7500.csv,1,1687891336600,16.0,100000,80244,20710,7982151,19910,79290,10,80090,1
multi_pi-10-7500.csv,1,1687891337104,16.5,100000,79440,21740,7982151,20690,78260,10,79310,1
multi_pi-10-7500.csv,1,1687891337605,17.0,100000,78750,22750,7982151,21360,77250,10,78640,1
multi_pi-10-7500.csv,1,1687891338103,17.5,100000,77829,23640,7982151,22280,76360,10,77720,1
multi_pi-10-7500.csv,1,1687891338601,18.0,100000,76749,24520,7982151,23340,75480,10,76660,1
multi_pi-10-7500.csv,1,1687891339104,18.5,100000,75796,25390,7982151,24370,74610,10,75630,1
multi_pi-10-7500.csv,1,1687891339600,19.0,100000,74750,26290,7982151,25330,73710,10,74670,1
multi_pi-10-7500.csv,1,1687891340102,19.5,100000,73941,27180,7982151,26120,72820,10,73880,1
multi_pi-10-7500.csv,1,1687891340601,20.0,100000,73199,27860,7982151,26900,72140,10,73100,1
multi_pi-10-7500.csv,1,1687891341102,20.5,100000,72250,28860,7982151,27810,71140,10,72190,1
multi_pi-10-7500.csv,1,1687891341603,21.0,100000,71249,29690,7982151,28830,70310,10,71170,1
multi_pi-10-7500.csv,1,1687891342107,21.5,100000,70150,30570,7982151,29950,69430,10,70050,1
multi_pi-10-7500.csv,1,1687891342605,22.0,100000,69050,31580,7982151,31070,68420,10,68930,1
multi_pi-10-7500.csv,1,1687891343109,22.5,100000,67845,32490,7982151,32250,67510,10,67750,1
multi_pi-10-7500.csv,1,1687891343604,23.0,100000,66800,33350,7982151,33300,66650,10,66700,1
multi_pi-10-7500.csv,1,1687891344104,23.5,100000,65845,34240,7982151,34300,65760,10,65700,1
multi_pi-10-7500.csv,1,1687891344605,24.0,100000,65050,35080,7982151,35370,64920,10,64630,1
multi_pi-10-7500.csv,1,1687891345106,24.5,100000,64145,36050,7982151,36330,63950,10,63670,1
multi_pi-10-7500.csv,1,1687891345603,25.0,100000,63199,36920,7982151,37420,63080,10,62580,1
multi_pi-10-7500.csv,1,1687891346123,25.5,100000,62222,37930,7982151,38540,62070,10,61460,1
multi_pi-10-7500.csv,1,1687891346606,26.0,100000,61150,38920,7982151,39470,61080,10,60530,1
multi_pi-10-7500.csv,1,1687891347105,26.5,100000,60000,40070,7982151,40400,59930,10,59600,1
multi_pi-10-7500.csv,1,1687891347605,27.0,100000,59150,40980,7982151,41220,59020,10,58780,1
multi_pi-10-7500.csv,1,1687891348118,27.5,100000,58300,41920,7982151,41850,58080,10,58150,1
multi_pi-10-7500.csv,1,1687891348620,28.0,100000,57450,43040,7982151,42670,56960,10,57330,1
multi_pi-10-7500.csv,1,1687891349119,28.5,100000,56287,44040,7982151,43820,55960,10,56180,1
multi_pi-10-7500.csv,1,1687891349612,29.0,100000,55300,45050,7982151,44830,54950,10,55170,1
multi_pi-10-7500.csv,1,1687891350116,29.5,100000,54250,46050,7982151,45880,53950,10,54120,1
multi_pi-10-7500.csv,1,1687891350615,30.0,100000,53150,47040,7982151,46950,52960,10,53050,1
multi_pi-10-7500.csv,1,1687891351115,30.5,100000,52200,47890,7982151,47980,52110,10,52020,1
multi_pi-10-7500.csv,1,1687891351616,31.0,100000,51350,48760,7982151,49060,51240,10,50940,1
multi_pi-10-7500.csv,1,1687891352121,31.5,100000,50491,49620,7982151,50210,50380,10,49790,1
multi_pi-10-7500.csv,1,1687891352621,32.0,100000,49450,50660,7982151,51280,49340,10,48720,1
multi_pi-10-7500.csv,1,1687891353123,32.5,100000,48546,51580,7982151,52290,48420,10,47710,1
multi_pi-10-7500.csv,1,1687891353625,33.0,100000,47500,52610,7982151,53290,47390,10,46710,1
multi_pi-10-7500.csv,1,1687891354118,33.5,100000,46600,53490,7982151,54500,46510,10,45500,1
multi_pi-10-7500.csv,1,1687891354616,34.0,100000,45949,54150,7982151,55810,45850,10,44190,1
multi_pi-10-7500.csv,1,1687891355120,34.5,100000,45050,55080,7982151,56750,44920,10,43250,1
multi_pi-10-7500.csv,1,1687891355616,35.0,100000,44200,55890,7982151,57430,44110,10,42570,1
multi_pi-10-7500.csv,1,1687891356114,35.5,100000,43349,56740,7982151,58550,43260,10,41450,1
multi_pi-10-7500.csv,1,1687891356623,36.0,100000,42400,57680,7982151,59670,42320,10,40330,1
multi_pi-10-7500.csv,1,1687891357117,36.5,100000,41376,58750,7982151,60590,41250,10,39410,1
multi_pi-10-7500.csv,1,1687891357648,37.0,100000,40250,59890,7982151,61510,40110,10,38490,1
multi_pi-10-7500.csv,1,1687891358126,37.5,100000,39199,60900,7982151,62380,39100,10,37620,1
multi_pi-10-7500.csv,1,1687891358618,38.0,100000,38342,61720,7982151,63510,38280,10,36490,1
multi_pi-10-7500.csv,1,1687891359118,38.5,100000,37450,62650,7982151,64510,37350,10,35490,1
multi_pi-10-7500.csv,1,1687891359618,39.0,100000,36434,63650,7982151,65430,36350,10,34570,1
multi_pi-10-7500.csv,1,1687891360119,39.5,100000,35750,64370,7982151,66430,35630,10,33570,1
multi_pi-10-7500.csv,1,1687891360620,40.0,100000,35150,65000,7982151,67410,35000,10,32590,1
multi_pi-10-7500.csv,1,1687891361123,40.5,100000,34200,65910,7982151,68420,34090,10,31580,1
multi_pi-10-7500.csv,1,1687891361623,41.0,100000,33233,66870,7982151,69520,33130,10,30480,1
multi_pi-10-7500.csv,1,1687891362121,41.5,100000,32193,67900,7982151,70600,32100,10,29400,1
multi_pi-10-7500.csv,1,1687891362619,42.0,100000,31350,68770,7982151,71590,31230,10,28410,1
multi_pi-10-7500.csv,1,1687891363119,42.5,100000,30650,69460,7982151,72480,30540,10,27520,1
multi_pi-10-7500.csv,1,1687891363621,43.0,100000,29831,70250,7982151,73570,29750,10,26430,1
multi_pi-10-7500.csv,1,1687891364128,43.5,100000,29144,71050,7982151,74720,28950,10,25280,1
multi_pi-10-7500.csv,1,1687891364624,44.0,100000,28198,71970,7982151,75950,28030,10,24050,1
multi_pi-10-7500.csv,1,1687891365121,44.5,100000,27200,72910,7982151,76970,27090,10,23030,1
multi_pi-10-7500.csv,1,1687891365621,45.0,100000,26349,73800,7982151,78000,26200,10,22000,1
multi_pi-10-7500.csv,1,1687891366122,45.5,100000,25463,74690,7982151,79070,25310,10,20930,1
multi_pi-10-7500.csv,1,1687891366622,46.0,100000,24350,75800,7982151,79950,24200,10,20050,1
multi_pi-10-7500.csv,1,1687891367131,46.5,100000,23199,76890,7982151,80880,23110,10,19120,1
multi_pi-10-7500.csv,1,1687891367624,47.0,100000,22197,77900,7982151,81800,22100,10,18200,1
multi_pi-10-7500.csv,1,1687891368122,47.5,100000,21250,78870,7982151,82790,21130,10,17210,1
multi_pi-10-7500.csv,1,1687891368623,48.0,100000,20350,79750,7982151,83850,20250,10,16150,1
multi_pi-10-7500.csv,1,1687891369120,48.5,100000,19450,80630,7982151,84860,19370,10,15140,1
multi_pi-10-7500.csv,1,1687891369620,49.0,100000,18750,81370,7982151,85920,18630,10,14080,1
multi_pi-10-7500.csv,1,1687891370123,49.5,100000,18400,81960,7982151,86800,18040,10,13200,1
multi_pi-10-7500.csv,1,1687891370622,50.0,100000,17350,82730,7982151,87550,17270,10,12450,1
multi_pi-10-7500.csv,1,1687891371124,50.5,100000,16400,83680,7982151,88590,16320,10,11410,1
multi_pi-10-7500.csv,1,1687891371631,51.0,100000,15491,84640,7982151,89590,15360,10,10410,1
multi_pi-10-7500.csv,1,1687891372123,51.5,100000,14450,85630,7982151,90550,14370,10,9450,1
multi_pi-10-7500.csv,1,1687891372628,52.0,100000,13550,86550,7982151,91650,13450,10,8350,1
multi_pi-10-7500.csv,1,1687891373124,52.5,100000,12800,87290,7982151,92850,12710,10,7150,1
multi_pi-10-7500.csv,1,1687891373624,53.0,100000,11850,88260,7982151,93860,11740,10,6140,1
multi_pi-10-7500.csv,1,1687891374124,53.5,100000,10750,89370,7982151,94750,10630,10,5250,1
multi_pi-10-7500.csv,1,1687891374624,54.0,100000,9700,90370,7982151,95720,9630,10,4280,1
multi_pi-10-7500.csv,1,1687891375126,54.5,100000,8850,91280,7982151,96760,8720,10,3240,1
multi_pi-10-7500.csv,1,1687891375626,55.0,100000,7850,92300,7982151,97780,7700,10,2220,1
multi_pi-10-7500.csv,1,1687891376127,55.5,100000,6800,93270,7982151,98710,6730,10,1290,1
multi_pi-10-7500.csv,1,1687891376625,56.0,100000,6500,93890,7982151,99430,6110,10,570,1
multi_pi-10-7500.csv,1,1687891377127,56.5,100000,5240,94850,7982151,100000,5150,10,0,1
multi_pi-10-7500.csv,1,1687891377635,57.0,100000,4350,95760,7982151,100000,4240,10,0,1
multi_pi-10-7500.csv,1,1687891378128,57.5,100000,3698,96430,7982151,100000,3570,10,0,1
multi_pi-10-7500.csv,1,1687891378627,58.0,100000,2850,97230,7982151,100000,2770,10,0,1
multi_pi-10-7500.csv,1,1687891379130,58.5,100000,2037,98070,7982151,100000,1930,10,0,1
multi_pi-10-7500.csv,1,1687891379631,59.0,100000,1150,98930,7982151,100000,1070,10,0,1
multi_pi-10-7500.csv,1,1687891380137,59.5,100000,200,99920,7982151,100000,80,10,0,1
multi_pi-10-7500.csv,1,1687891380628,60.0,100000,50,100000,7982151,100000,0,10,0,1
multi_pi-10-7500.csv,3,1687891127506,0.0,0,196,0,7782151,0,0,100,0,1
multi_pi-10-7500.csv,3,1687891128007,0.5,450,646,400,7782601,300,50,100,150,1
multi_pi-10-7500.csv,3,1687891128509,1.0,10000,7000,3800,7792151,3800,6200,100,6200,1
multi_pi-10-7500.csv,3,1687891129018,1.5,18850,12560,7200,7801001,7400,11650,100,11450,1
multi_pi-10-7500.csv,3,1687891129511,2.0,24150,14490,11400,7806301,10600,12750,100,13550,1
multi_pi-10-7500.csv,3,1687891130017,2.5,32000,18200,14800,7814151,14700,17200,100,17300,1
multi_pi-10-7500.csv,3,1687891130509,3.0,37450,21387,17000,7819601,17000,20450,100,20450,1
multi_pi-10-7500.csv,3,1687891131025,3.5,42850,23450,20500,7825001,21000,22350,100,21850,1
multi_pi-10-7500.csv,3,1687891131520,4.0,49050,26000,23900,7831201,25000,25150,100,24050,1
multi_pi-10-7500.csv,3,1687891132006,4.5,54750,28552,26900,7836901,29400,27850,100,25350,1
multi_pi-10-7500.csv,3,1687891132512,5.0,61650,32200,30300,7843801,33300,31350,100,28350,1
multi_pi-10-7500.csv,3,1687891133006,5.5,71700,38900,33500,7853851,36900,38200,100,34800,1
multi_pi-10-7500.csv,3,1687891133505,6.0,80700,44500,37300,7862851,40100,43400,100,40600,1
multi_pi-10-7500.csv,3,1687891134005,6.5,88400,48450,40800,7870551,43900,47600,100,44500,1
multi_pi-10-7500.csv,3,1687891134508,7.0,94800,51250,44400,7876951,47800,50400,100,47000,1
multi_pi-10-7500.csv,3,1687891135005,7.5,100000,52915,47900,7882151,51900,52100,100,48100,1
multi_pi-10-7500.csv,3,1687891135513,8.0,100000,48600,52300,7882151,55500,47700,100,44500,1
multi_pi-10-7500.csv,3,1687891136016,8.5,100000,45145,56000,7882151,59900,44000,100,40100,1
multi_pi-10-7500.csv,3,1687891136511,9.0,100000,41231,59800,7882151,62900,40200,100,37100,1
multi_pi-10-7500.csv,3,1687891137006,9.5,100000,36900,63900,7882151,65800,36100,100,34200,1
multi_pi-10-7500.csv,3,1687891137511,10.0,100000,33119,68100,7882151,69500,31900,100,30500,1
multi_pi-10-7500.csv,3,1687891138007,10.5,100000,29620,71000,7882151,72500,29000,100,27500,1
multi_pi-10-7500.csv,3,1687891138509,11.0,100000,26227,74600,7882151,77200,25400,100,22800,1
multi_pi-10-7500.csv,3,1687891139006,11.5,100000,22950,78100,7882151,81700,21900,100,18300,1
multi_pi-10-7500.csv,3,1687891139506,12.0,100000,19213,81900,7882151,85200,18100,100,14800,1
multi_pi-10-7500.csv,3,1687891140007,12.5,100000,16050,84800,7882151,90200,15200,100,9800,1
multi_pi-10-7500.csv,3,1687891140514,13.0,100000,11850,89300,7882151,94000,10700,100,6000,1
multi_pi-10-7500.csv,3,1687891141011,13.5,100000,7650,93200,7882151,97700,6800,100,2300,1
multi_pi-10-7500.csv,3,1687891141507,14.0,100000,3650,97600,7882151,100000,2400,100,0,1
multi_pi-10-7500.csv,3,1687891142008,14.5,100000,149,100000,7882151,100000,0,100,0,1
multi_pi-10-7500.csv,2,1687891076976,0.0,0,49,0,7682151,0,0,100,0,1
multi_pi-10-7500.csv,2,1687891077481,0.5,3100,2550,1750,7685251,1500,1350,100,1600,1
multi_pi-10-7500.csv,2,1687891078029,1.1,12100,9214,4650,7694251,4000,7450,100,8100,1
multi_pi-10-7500.csv,2,1687891078484,1.5,19200,13315,8150,7701351,6700,11050,100,12500,1
multi_pi-10-7500.csv,2,1687891078976,2.0,27800,18818,11650,7709951,9700,16150,100,18100,1
multi_pi-10-7500.csv,2,1687891079482,2.5,37300,25541,14750,7719451,12900,22550,100,24400,1
multi_pi-10-7500.csv,2,1687891079983,3.0,46650,31191,17850,7728801,16300,28800,100,30350,1
multi_pi-10-7500.csv,2,1687891080484,3.5,55650,37686,22350,7737801,19100,33300,100,36550,1
multi_pi-10-7500.csv,2,1687891080980,4.0,61700,39719,26350,7743851,22800,35350,100,38900,1
multi_pi-10-7500.csv,2,1687891081508,4.5,67850,41900,29950,7750001,27100,37900,100,40750,1
multi_pi-10-7500.csv,2,1687891081982,5.0,74550,44600,33450,7756701,30700,41100,100,43850,1
multi_pi-10-7500.csv,2,1687891082486,5.5,84800,51750,36750,7766951,34400,48050,100,50400,1
multi_pi-10-7500.csv,2,1687891082983,6.0,93800,56700,39850,7775951,38000,53950,100,55800,1
multi_pi-10-7500.csv,2,1687891083483,6.5,100000,59550,42250,7782151,41500,57750,100,58500,1
multi_pi-10-7500.csv,2,1687891083978,7.0,100000,55671,45050,7782151,46100,54950,100,53900,1
multi_pi-10-7500.csv,2,1687891084479,7.5,100000,52191,48950,7782151,50000,51050,100,50000,1
multi_pi-10-7500.csv,2,1687891084985,8.0,100000,48386,52850,7782151,54100,47150,100,45900,1
multi_pi-10-7500.csv,2,1687891085486,8.5,100000,44954,55750,7782151,57300,44250,100,42700,1
multi_pi-10-7500.csv,2,1687891085982,9.0,100000,41700,58950,7782151,61500,41050,100,38500,1
multi_pi-10-7500.csv,2,1687891086480,9.5,100000,38284,62750,7782151,65900,37250,100,34100,1
multi_pi-10-7500.csv,2,1687891086981,10.0,100000,33583,67150,7782151,69500,32850,100,30500,1
multi_pi-10-7500.csv,2,1687891087485,10.5,100000,30292,70950,7782151,73800,29050,100,26200,1
multi_pi-10-7500.csv,2,1687891087985,11.0,100000,25791,75150,7782151,77500,24850,100,22500,1
multi_pi-10-7500.csv,2,1687891088497,11.5,100000,21050,79750,7782151,81000,20250,100,19000,1
multi_pi-10-7500.csv,2,1687891088993,12.0,100000,17650,83450,7782151,85300,16550,100,14700,1
multi_pi-10-7500.csv,2,1687891089495,12.5,100000,13450,87450,7782151,89400,12550,100,10600,1
multi_pi-10-7500.csv,2,1687891089994,13.0,100000,9067,92250,7782151,93300,7750,100,6700,1
multi_pi-10-7500.csv,2,1687891090482,13.5,100000,4600,96250,7782151,97200,3750,100,2800,1
multi_pi-10-7500.csv,2,1687891090987,14.0,100000,850,100000,7782151,100000,0,100,0,1
multi_pi-10-7500.csv,1,1687891057468,0.0,0,250,0,7582151,0,0,100,0,1
multi_pi-10-7500.csv,1,1687891057998,0.5,5200,3500,3550,7587351,3050,1650,100,2150,1
multi_pi-10-7500.csv,1,1687891058483,1.0,9800,4383,6750,7591951,6550,3050,100,3250,1
multi_pi-10-7500.csv,1,1687891058986,1.5,16850,8505,9650,7599001,10150,7200,100,6700,1
multi_pi-10-7500.csv,1,1687891059492,2.0,22400,10500,12750,7604551,13850,9650,100,8550,1
multi_pi-10-7500.csv,1,1687891059972,2.5,27800,12189,16350,7609951,17750,11450,100,10050,1
multi_pi-10-7500.csv,1,1687891060476,3.0,33400,14283,20050,7615551,21150,13350,100,12250,1
multi_pi-10-7500.csv,1,1687891060977,3.5,39450,16444,23850,7621601,24850,15600,100,14600,1
multi_pi-10-7500.csv,1,1687891061467,4.0,48000,21400,27450,7630151,28050,20550,100,19950,1
multi_pi-10-7500.csv,1,1687891061985,4.5,54650,24650,30750,7636801,32050,23900,100,22600,1
multi_pi-10-7500.csv,1,1687891062517,5.0,60150,27600,33750,7642301,36650,26400,100,23500,1
multi_pi-10-7500.csv,1,1687891062972,5.5,65150,29949,36150,7647301,38950,29000,100,26200,1
multi_pi-10-7500.csv,1,1687891063471,6.0,75900,37250,39450,7658051,42150,36450,100,33750,1
multi_pi-10-7500.csv,1,1687891063971,6.5,83450,41150,42950,7665601,45550,40500,100,37900,1
multi_pi-10-7500.csv,1,1687891064486,7.0,88550,43300,46350,7670701,48950,42200,100,39600,1
multi_pi-10-7500.csv,1,1687891064983,7.5,97750,52150,48550,7679901,51350,49200,100,46400,1
multi_pi-10-7500.csv,1,1687891065469,8.0,100000,49052,51850,7682151,55250,48150,100,44750,1
multi_pi-10-7500.csv,1,1687891065970,8.5,100000,46150,54850,7682151,58050,45150,100,41950,1
multi_pi-10-7500.csv,1,1687891066471,9.0,100000,43381,57350,7682151,62650,42650,100,37350,1
multi_pi-10-7500.csv,1,1687891066972,9.5,100000,40283,60550,7682151,67550,39450,100,32450,1
multi_pi-10-7500.csv,1,1687891067469,10.0,100000,36972,63550,7682151,72350,36450,100,27650,1
multi_pi-10-7500.csv,1,1687891067972,10.5,100000,33190,67650,7682151,76350,32350,100,23650,1
multi_pi-10-7500.csv,1,1687891068476,11.0,100000,29300,71450,7682151,80150,28550,100,19850,1
multi_pi-10-7500.csv,1,1687891068973,11.5,100000,26094,74850,7682151,84350,25150,100,15650,1
multi_pi-10-7500.csv,1,1687891069476,12.0,100000,21691,78950,7682151,88250,21050,100,11750,1
multi_pi-10-7500.csv,1,1687891069977,12.5,100000,17885,82950,7682151,92150,17050,100,7850,1
multi_pi-10-7500.csv,1,1687891070473,13.0,100000,14884,85950,7682151,95550,14050,100,4450,1
multi_pi-10-7500.csv,1,1687891070977,13.5,100000,11693,89450,7682151,99850,10550,100,150,1
multi_pi-10-7500.csv,1,1687891071479,14.0,100000,7697,93650,7682151,100000,6350,100,0,1
multi_pi-10-7500.csv,1,1687891071974,14.5,100000,3058,97550,7682151,100000,2450,100,0,1
multi_pi-10-7500.csv,1,1687891072476,15.0,100000,49,100000,7682151,100000,0,100,0,1
multi_pi-10-7500.csv,3,1687870584973,0.0,0,1600,0,7382151,0,0,1000,0,1
multi_pi-10-7500.csv,3,1687870585473,0.5,5200,3847,4350,7387351,3950,850,1000,1250,1
multi_pi-10-7500.csv,3,1687870585987,1.0,13700,10000,10750,7395851,8700,2950,1000,5000,1
multi_pi-10-7500.csv,3,1687870586473,1.5,21650,15303,14750,7403801,14700,6900,1000,6950,1
multi_pi-10-7500.csv,3,1687870586983,2.0,30550,17896,20750,7412701,19700,9800,1000,10850,1
multi_pi-10-7500.csv,3,1687870587515,2.5,37200,21500,23750,7419351,22700,13450,1000,14500,1
multi_pi-10-7500.csv,3,1687870587983,3.0,44550,21873,28750,7426701,28700,15800,1000,15850,1
multi_pi-10-7500.csv,3,1687870588477,3.5,52250,25500,33750,7434401,33700,18500,1000,18550,1
multi_pi-10-7500.csv,3,1687870588980,4.0,61400,31696,37750,7443551,38700,23650,1000,22700,1
multi_pi-10-7500.csv,3,1687870589496,4.5,69650,36000,43750,7451801,43700,25900,1000,25950,1
multi_pi-10-7500.csv,3,1687870589975,5.0,77950,37300,47750,7460101,48700,30200,1000,29250,1
multi_pi-10-7500.csv,3,1687870590482,5.5,85650,41950,50750,7467801,53700,34900,1000,31950,1
multi_pi-10-7500.csv,3,1687870590976,6.0,91800,43100,55750,7473951,59700,36050,1000,32100,1
multi_pi-10-7500.csv,3,1687870591474,6.5,100000,47292,60750,7482151,63700,39250,1000,36300,1
multi_pi-10-7500.csv,3,1687870591978,7.0,100000,39287,66750,7482151,70700,33250,1000,29300,1
multi_pi-10-7500.csv,3,1687870592477,7.5,100000,34254,71750,7482151,77700,28250,1000,22300,1
multi_pi-10-7500.csv,3,1687870592986,8.0,100000,31250,75750,7482151,81700,24250,1000,18300,1
multi_pi-10-7500.csv,3,1687870593477,8.5,100000,28297,79750,7482151,87700,20250,1000,12300,1
multi_pi-10-7500.csv,3,1687870593975,9.0,100000,22289,84750,7482151,92700,15250,1000,7300,1
multi_pi-10-7500.csv,3,1687870594475,9.5,100000,15300,89750,7482151,98700,10250,1000,1300,1
multi_pi-10-7500.csv,3,1687870594974,10.0,100000,14296,92750,7482151,100000,7250,1000,0,1
multi_pi-10-7500.csv,3,1687870595472,10.5,100000,8275,97750,7482151,100000,2250,1000,0,1
multi_pi-10-7500.csv,3,1687870595983,11.0,100000,3250,100000,7482151,100000,0,1000,0,1
multi_pi-10-7500.csv,2,1687870555464,0.0,0,16,0,7282151,0,0,1000,0,1
multi_pi-10-7500.csv,2,1687870555974,0.5,2200,1962,1950,7284351,2050,250,1000,150,1
multi_pi-10-7500.csv,2,1687870556473,1.0,9300,6750,8600,7291451,8250,700,1000,1050,1
multi_pi-10-7500.csv,2,1687870556966,1.5,16000,9525,13600,7298151,14450,2400,1000,1550,1
multi_pi-10-7500.csv,2,1687870557479,2.0,23450,11029,17600,7305601,18450,5850,1000,5000,1
multi_pi-10-7500.csv,2,1687870557962,2.5,31150,16749,22600,7313301,22450,8550,1000,8700,1
multi_pi-10-7500.csv,2,1687870558473,3.0,39100,18672,28600,7321251,26450,10500,1000,12650,1
multi_pi-10-7500.csv,2,1687870558962,3.5,47550,24956,31600,7329701,31450,15950,1000,16100,1
multi_pi-10-7500.csv,2,1687870559484,4.0,56400,30000,36600,7338551,37450,19800,1000,18950,1
multi_pi-10-7500.csv,2,1687870559963,4.5,63400,30841,41600,7345551,42450,21800,1000,20950,1
multi_pi-10-7500.csv,2,1687870560476,5.0,70500,33100,46600,7352651,45450,23900,1000,25050,1
multi_pi-10-7500.csv,2,1687870560971,5.5,78300,33740,51600,7360451,50450,26700,1000,27850,1
multi_pi-10-7500.csv,2,1687870561473,6.0,86800,40399,56600,7368951,55450,30200,1000,31350,1
multi_pi-10-7500.csv,2,1687870561971,6.5,96000,43450,59600,7378151,61450,36400,1000,34550,1
multi_pi-10-7500.csv,2,1687870562500,7.0,100000,42425,63600,7382151,67450,36400,1000,32550,1
multi_pi-10-7500.csv,2,1687870562966,7.5,100000,36449,69600,7382151,71450,30400,1000,28550,1
multi_pi-10-7500.csv,2,1687870563467,8.0,100000,35415,73600,7382151,76450,26400,1000,23550,1
multi_pi-10-7500.csv,2,1687870563978,8.5,100000,31450,77600,7382151,82450,22400,1000,17550,1
multi_pi-10-7500.csv,2,1687870564472,9.0,100000,24438,82600,7382151,87450,17400,1000,12550,1
multi_pi-10-7500.csv,2,1687870564966,9.5,100000,20450,86600,7382151,91450,13400,1000,8550,1
multi_pi-10-7500.csv,2,1687870565506,10.0,100000,15400,92600,7382151,96450,7400,1000,3550,1
multi_pi-10-7500.csv,2,1687870565973,10.5,100000,7450,98600,7382151,100000,1400,1000,0,1
multi_pi-10-7500.csv,2,1687870566474,11.0,100000,3400,100000,7382151,100000,0,1000,0,1
multi_pi-10-7500.csv,1,1687870521946,0.0,0,6,0,7182151,0,0,1000,0,1
multi_pi-10-7500.csv,1,1687870522464,0.5,1250,1256,1050,7183401,1100,200,1000,150,1
multi_pi-10-7500.csv,1,1687870522947,1.0,9900,9906,4050,7192051,5100,5850,1000,4800,1
multi_pi-10-7500.csv,1,1687870523481,1.5,20500,20506,6050,7202651,6100,14450,1000,14400,1
multi_pi-10-7500.csv,1,1687870523948,2.0,30400,30406,7050,7212551,8100,23350,1000,22300,1
multi_pi-10-7500.csv,1,1687870524460,2.5,40300,40250,8050,7222451,9100,32250,1000,31200,1
multi_pi-10-7500.csv,1,1687870524953,3.0,49900,49850,11050,7232051,10100,38850,1000,39800,1
multi_pi-10-7500.csv,1,1687870525473,3.5,59100,59050,14050,7241251,13100,45050,1000,46000,1
multi_pi-10-7500.csv,1,1687870525951,4.0,68200,60150,18050,7250351,16100,50150,1000,52100,1
multi_pi-10-7500.csv,1,1687870526448,4.5,77350,64266,22050,7259501,20100,55300,1000,57250,1
multi_pi-10-7500.csv,1,1687870526952,5.0,86050,69950,27050,7268201,24100,59000,1000,61950,1
multi_pi-10-7500.csv,1,1687870527450,5.5,93500,71404,31050,7275651,28100,62450,1000,65400,1
multi_pi-10-7500.csv,1,1687870527949,6.0,100000,76000,32050,7282151,32100,67950,1000,67900,1
multi_pi-10-7500.csv,1,1687870528451,6.5,100000,69993,37050,7282151,37100,62950,1000,62900,1
multi_pi-10-7500.csv,1,1687870528956,7.0,100000,67948,43050,7282151,40100,56950,1000,59900,1
multi_pi-10-7500.csv,1,1687870529456,7.5,100000,62900,48050,7282151,46100,51950,1000,53900,1
multi_pi-10-7500.csv,1,1687870529978,8.0,100000,54974,53050,7282151,53100,46950,1000,46900,1
multi_pi-10-7500.csv,1,1687870530449,8.5,100000,48973,58050,7282151,59100,41950,1000,40900,1
multi_pi-10-7500.csv,1,1687870530949,9.0,100000,43000,64050,7282151,65100,35950,1000,34900,1
multi_pi-10-7500.csv,1,1687870531450,9.5,100000,37998,67050,7282151,71100,32950,1000,28900,1
multi_pi-10-7500.csv,1,1687870531955,10.0,100000,34968,70050,7282151,77100,29950,1000,22900,1
multi_pi-10-7500.csv,1,1687870532459,10.5,100000,32000,75050,7282151,80100,24950,1000,19900,1
multi_pi-10-7500.csv,1,1687870532952,11.0,100000,23992,82050,7282151,84100,17950,1000,15900,1
multi_pi-10-7500.csv,1,1687870533450,11.5,100000,20975,87050,7282151,90100,12950,1000,9900,1
multi_pi-10-7500.csv,1,1687870533970,12.0,100000,12950,94050,7282151,97100,5950,1000,2900,1
multi_pi-10-7500.csv,1,1687870534458,12.5,100000,7950,99050,7282151,100000,950,1000,0,1
multi_pi-10-7500.csv,1,1687870534962,13.0,100000,4000,100000,7282151,100000,0,1000,0,1
multi_pi-10-7500.csv,3,1687869938728,0.0,0,50,0,7082151,0,0,2500,0,1
multi_pi-10-7500.csv,3,1687869939231,0.5,2150,1589,2150,7084301,2050,0,2500,100,1
multi_pi-10-7500.csv,3,1687869939807,1.1,9750,8038,9600,7091901,9600,150,2500,150,1
multi_pi-10-7500.csv,3,1687869940240,1.5,16700,9711,15450,7098851,16050,1250,2500,650,1
multi_pi-10-7500.csv,3,1687869940751,2.0,25550,18550,22950,7107701,20850,2600,2500,4700,1
multi_pi-10-7500.csv,3,1687869941233,2.5,33050,22612,27950,7115201,25850,5100,2500,7200,1
multi_pi-10-7500.csv,3,1687869941728,3.0,42900,32462,30450,7125051,30850,12450,2500,12050,1
multi_pi-10-7500.csv,3,1687869942252,3.5,51700,33750,35450,7133851,35850,16250,2500,15850,1
multi_pi-10-7500.csv,3,1687869942747,4.0,60950,40550,37950,7143101,40850,23000,2500,20100,1
multi_pi-10-7500.csv,3,1687869943234,4.5,67500,47100,42950,7149651,45850,24550,2500,21650,1
multi_pi-10-7500.csv,3,1687869943731,5.0,77550,44615,47950,7159701,48350,29600,2500,29200,1
multi_pi-10-7500.csv,3,1687869944229,5.5,86200,53265,52950,7168351,53350,33250,2500,32850,1
multi_pi-10-7500.csv,3,1687869944734,6.0,94200,61265,57950,7176351,58350,36250,2500,35850,1
multi_pi-10-7500.csv,3,1687869945231,6.5,100000,54596,62950,7182151,63350,37050,2500,36650,1
multi_pi-10-7500.csv,3,1687869945731,7.0,100000,47100,67950,7182151,68350,32050,2500,31650,1
multi_pi-10-7500.csv,3,1687869946259,7.5,100000,44196,75450,7182151,73350,24550,2500,26650,1
multi_pi-10-7500.csv,3,1687869946809,8.1,100000,39590,77950,7182151,83350,22050,2500,16650,1
multi_pi-10-7500.csv,3,1687869947251,8.5,100000,32100,85450,7182151,88350,14550,2500,11650,1
multi_pi-10-7500.csv,3,1687869947752,9.0,100000,27050,90450,7182151,93350,9550,2500,6650,1
multi_pi-10-7500.csv,3,1687869948232,9.5,100000,19559,95450,7182151,98350,4550,2500,1650,1
multi_pi-10-7500.csv,3,1687869948735,10.0,100000,17096,97950,7182151,100000,2050,2500,0,1
multi_pi-10-7500.csv,3,1687869949233,10.5,100000,14599,100000,7182151,100000,0,2500,0,1
multi_pi-10-7500.csv,2,1687869851193,0.0,0,1400,0,6982151,0,0,2500,0,1
multi_pi-10-7500.csv,2,1687869851708,0.5,5700,4711,5550,6987851,5600,150,2500,100,1
multi_pi-10-7500.csv,2,1687869852269,1.1,12350,10091,12350,6994501,12300,0,2500,50,1
multi_pi-10-7500.csv,2,1687869852735,1.5,18300,15387,14850,7000451,18150,3450,2500,150,1
multi_pi-10-7500.csv,2,1687869853196,2.0,25450,19932,22350,7007601,23400,3100,2500,2050,1
multi_pi-10-7500.csv,2,1687869853710,2.5,35800,28950,24850,7017951,30900,10950,2500,4900,1
multi_pi-10-7500.csv,2,1687869854197,3.0,43850,31735,29850,7026001,35900,14000,2500,7950,1
multi_pi-10-7500.csv,2,1687869854702,3.5,53550,33745,34850,7035701,35900,18700,2500,17650,1
multi_pi-10-7500.csv,2,1687869855196,4.0,62200,39876,39850,7044351,40900,22350,2500,21300,1
multi_pi-10-7500.csv,2,1687869855698,4.5,70800,44950,44850,7052951,43400,25950,2500,27400,1
multi_pi-10-7500.csv,2,1687869856210,5.0,79400,53550,52350,7061551,48400,27050,2500,31000,1
multi_pi-10-7500.csv,2,1687869856703,5.5,87450,56585,57350,7069601,53400,30100,2500,34050,1
multi_pi-10-7500.csv,2,1687869857204,6.0,95800,57400,62350,7077951,58400,33450,2500,37400,1
multi_pi-10-7500.csv,2,1687869857703,6.5,100000,50153,67350,7082151,65900,32650,2500,34100,1
multi_pi-10-7500.csv,2,1687869858202,7.0,100000,47650,72350,7082151,70900,27650,2500,29100,1
multi_pi-10-7500.csv,2,1687869858724,7.5,100000,45200,79850,7082151,75900,20150,2500,24100,1
multi_pi-10-7500.csv,2,1687869859205,8.0,100000,32699,84850,7082151,83400,15150,2500,16600,1
multi_pi-10-7500.csv,2,1687869859702,8.5,100000,31608,89850,7082151,88400,10150,2500,11600,1
multi_pi-10-7500.csv,2,1687869860203,9.0,100000,26650,92350,7082151,93400,7650,2500,6600,1
multi_pi-10-7500.csv,2,1687869860707,9.5,100000,20150,97350,7082151,98400,2650,2500,1600,1
multi_pi-10-7500.csv,2,1687869861208,10.0,100000,10199,100000,7082151,100000,0,2500,0,1
multi_pi-10-7500.csv,1,1687869811677,0.0,0,6400,0,6882151,0,0,2500,0,1
multi_pi-10-7500.csv,1,1687869812177,0.5,4050,10450,2400,6886201,2200,1650,2500,1850,1
multi_pi-10-7500.csv,1,1687869812678,1.0,12650,19050,6700,6894801,6150,5950,2500,6500,1
multi_pi-10-7500.csv,1,1687869813219,1.5,17150,23550,14200,6899301,13650,2950,2500,3500,1
multi_pi-10-7500.csv,1,1687869813682,2.0,25850,32250,14200,6908001,18650,11650,2500,7200,1
multi_pi-10-7500.csv,1,1687869814182,2.5,36250,42650,16700,6918401,18650,19550,2500,17600,1
multi_pi-10-7500.csv,1,1687869814688,3.0,45150,51550,16700,6927301,18650,28450,2500,26500,1
multi_pi-10-7500.csv,1,1687869815181,3.5,53150,59550,19200,6935301,21150,33950,2500,32000,1
multi_pi-10-7500.csv,1,1687869815683,4.0,62800,69200,21700,6944951,21150,41100,2500,41650,1
multi_pi-10-7500.csv,1,1687869816208,4.5,69800,69800,26700,6951951,26150,43100,2500,43650,1
multi_pi-10-7500.csv,1,1687869816720,5.0,78600,77688,29200,6960751,31150,49400,2500,47450,1
multi_pi-10-7500.csv,1,1687869817189,5.5,85950,77350,36700,6968101,31150,49250,2500,54800,1
multi_pi-10-7500.csv,1,1687869817711,6.0,93550,72420,39200,6975701,38650,54350,2500,54900,1
multi_pi-10-7500.csv,1,1687869818183,6.5,100000,73850,44200,6982151,43650,55800,2500,56350,1
multi_pi-10-7500.csv,1,1687869818689,7.0,100000,68300,49200,6982151,48650,50800,2500,51350,1
multi_pi-10-7500.csv,1,1687869819186,7.5,100000,63300,54200,6982151,56150,45800,2500,43850,1
multi_pi-10-7500.csv,1,1687869819680,8.0,100000,60850,59200,6982151,61150,40800,2500,38850,1
multi_pi-10-7500.csv,1,1687869820182,8.5,100000,53302,64200,6982151,66150,35800,2500,33850,1
multi_pi-10-7500.csv,1,1687869820721,9.0,100000,45800,71700,6982151,73650,28300,2500,26350,1
multi_pi-10-7500.csv,1,1687869821211,9.5,100000,38859,76700,6982151,81150,23300,2500,18850,1
multi_pi-10-7500.csv,1,1687869821683,10.0,100000,33302,81700,6982151,86150,18300,2500,13850,1
multi_pi-10-7500.csv,1,1687869822182,10.5,100000,28341,86700,6982151,91150,13300,2500,8850,1
multi_pi-10-7500.csv,1,1687869822774,11.1,100000,18887,96700,6982151,96150,3300,2500,3850,1
multi_pi-10-7500.csv,1,1687869823194,11.5,100000,15850,99200,6982151,100000,800,2500,0,1
multi_pi-10-7500.csv,1,1687869823683,12.0,100000,15850,100000,6982151,100000,0,2500,0,1
multi_pi-10-7500.csv,1,1687869510634,0,0,749,0,6582151,0,0,5000,0,1
multi_pi-10-7500.csv,1,1687869511157,0.5,2650,3399,2400,6584801,2500,250,5000,150,1
multi_pi-10-7500.csv,1,1687869511633,1,10700,11449,10000,6592851,9300,700,5000,1400,1
multi_pi-10-7500.csv,1,1687869512131,1.5,16800,17549,13550,6598951,13550,3250,5000,3250,1
multi_pi-10-7500.csv,1,1687869512641,2,27750,28499,13550,6609901,13550,14200,5000,14200,1
multi_pi-10-7500.csv,1,1687869513133,2.5,39950,40699,13550,6622101,13550,26400,5000,26400,1
multi_pi-10-7500.csv,1,1687869513634,3,49200,49949,13550,6631351,23550,35650,5000,25650,1
multi_pi-10-7500.csv,1,1687869514133,3.5,58900,59649,23550,6641051,23550,35350,5000,35350,1
multi_pi-10-7500.csv,1,1687869514647,4,70000,70749,23550,6652151,23550,46450,5000,46450,1
multi_pi-10-7500.csv,1,1687869515185,4.6,79450,79480,23550,6661601,28550,55900,5000,50900,1
multi_pi-10-7500.csv,1,1687869515660,5,86500,85000,28550,6668651,38550,57950,5000,47950,1
multi_pi-10-7500.csv,1,1687869516154,5.5,98000,96500,28550,6680151,38550,69450,5000,59450,1
multi_pi-10-7500.csv,1,1687869516666,6,100000,86450,43550,6682151,48550,56450,5000,51450,1
multi_pi-10-7500.csv,1,1687869517149,6.5,100000,86450,43550,6682151,48550,56450,5000,51450,1
multi_pi-10-7500.csv,1,1687869517659,7,100000,86450,53550,6682151,58550,46450,5000,41450,1
multi_pi-10-7500.csv,1,1687869518205,7.6,100000,86450,58550,6682151,63550,41450,5000,36450,1
multi_pi-10-7500.csv,1,1687869518653,8,100000,86450,63550,6682151,63550,36450,5000,36450,1
multi_pi-10-7500.csv,1,1687869519138,8.5,100000,76454,68550,6682151,68550,31450,5000,31450,1
multi_pi-10-7500.csv,1,1687869519686,9.1,100000,61500,73550,6682151,78550,26450,5000,21450,1
multi_pi-10-7500.csv,1,1687869520149,9.5,100000,61500,78550,6682151,83550,21450,5000,16450,1
multi_pi-10-7500.csv,1,1687869520658,10,100000,46498,88550,6682151,88550,11450,5000,11450,1
multi_pi-10-7500.csv,1,1687869521173,10.5,100000,46498,88550,6682151,93550,11450,5000,6450,1
multi_pi-10-7500.csv,1,1687869521682,11,100000,31491,98550,6682151,98550,1450,5000,1450,1
multi_pi-10-7500.csv,1,1687869522139,11.5,100000,31491,100000,6682151,100000,0,5000,0,1
multi_pi-10-7500.csv,3,1687869552651,0,0,1242,0,6782151,0,0,5000,0,1
multi_pi-10-7500.csv,3,1687869553158,0.5,3050,2500,2900,6785201,2650,150,5000,400,1
multi_pi-10-7500.csv,3,1687869553652,1,11700,8550,11250,6793851,9400,450,5000,2300,1
multi_pi-10-7500.csv,3,1687869554153,1.5,19500,14046,16150,6801651,18650,3350,5000,850,1
multi_pi-10-7500.csv,3,1687869554651,2,25800,17550,25150,6807951,23650,650,5000,2150,1
multi_pi-10-7500.csv,3,1687869555161,2.5,33900,24500,28859,6816051,33650,5041,5000,250,1
multi_pi-10-7500.csv,3,1687869555849,3.2,45550,36150,43859,6827701,38650,1691,5000,6900,1
multi_pi-10-7500.csv,3,1687869556186,3.5,52000,35862,43859,6834151,48650,8141,5000,3350,1
multi_pi-10-7500.csv,3,1687869556661,4,62450,38840,48859,6844601,48650,13591,5000,13800,1
multi_pi-10-7500.csv,3,1687869557156,4.5,72700,49090,53859,6854851,48650,18841,5000,24050,1
multi_pi-10-7500.csv,3,1687869557651,5,79750,56140,58859,6861901,58650,20891,5000,21100,1
multi_pi-10-7500.csv,3,1687869558153,5.5,90900,62900,63859,6873051,58650,27041,5000,32250,1
multi_pi-10-7500.csv,3,1687869558652,6,98050,70050,68859,6880201,68650,29191,5000,29400,1
multi_pi-10-7500.csv,3,1687869559153,6.5,100000,72000,73859,6882151,68650,26141,5000,31350,1
multi_pi-10-7500.csv,3,1687869559654,7,100000,56379,78859,6882151,78650,21141,5000,21350,1
multi_pi-10-7500.csv,3,1687869560154,7.5,100000,56379,83859,6882151,78650,16141,5000,21350,1
multi_pi-10-7500.csv,3,1687869560688,8,100000,41376,88859,6882151,88650,11141,5000,11350,1
multi_pi-10-7500.csv,3,1687869561192,8.5,100000,36400,93859,6882151,98650,6141,5000,1350,1
multi_pi-10-7500.csv,3,1687869561650,9,100000,36400,98859,6882151,98650,1141,5000,1350,1
multi_pi-10-7500.csv,3,1687869562151,9.5,100000,31391,100000,6882151,100000,0,5000,0,1
multi_pi-10-7500.csv,2,1687869530641,0,0,1468,0,6682151,0,0,5000,0,1
multi_pi-10-7500.csv,2,1687869531140,0.5,1750,1584,1450,6683901,1350,300,5000,400,1
multi_pi-10-7500.csv,2,1687869531646,1,11850,11050,9600,6694001,9350,2250,5000,2500,1
multi_pi-10-7500.csv,2,1687869532146,1.5,20150,17750,17650,6702301,19400,2500,5000,750,1
multi_pi-10-7500.csv,2,1687869532642,2,27700,23841,27350,6709851,23800,350,5000,3900,1
multi_pi-10-7500.csv,2,1687869533152,2.5,36400,30050,32350,6718551,33800,4050,5000,2600,1
multi_pi-10-7500.csv,2,1687869533641,3,46250,37596,37350,6728401,33800,8900,5000,12450,1
multi_pi-10-7500.csv,2,1687869534147,3.5,54300,45600,42350,6736451,43800,11950,5000,10500,1
multi_pi-10-7500.csv,2,1687869534641,4,64750,56050,47350,6746901,43800,17400,5000,20950,1
multi_pi-10-7500.csv,2,1687869535142,4.5,72050,57750,52350,6754201,53800,19700,5000,18250,1
multi_pi-10-7500.csv,2,1687869535644,5,81150,66850,57350,6763301,53800,23800,5000,27350,1
multi_pi-10-7500.csv,2,1687869536200,5.6,90450,66674,62350,6772601,63800,28100,5000,26650,1
multi_pi-10-7500.csv,2,1687869536649,6,96550,64224,67350,6778701,63800,29200,5000,32750,1
multi_pi-10-7500.csv,2,1687869537162,6.5,100000,67674,72350,6782151,73800,27650,5000,26200,1
multi_pi-10-7500.csv,2,1687869537660,7,100000,62650,77350,6782151,73800,22650,5000,26200,1
multi_pi-10-7500.csv,2,1687869538175,7.5,100000,57700,82350,6782151,83800,17650,5000,16200,1
multi_pi-10-7500.csv,2,1687869538661,8,100000,52650,87350,6782151,83800,12650,5000,16200,1
multi_pi-10-7500.csv,2,1687869539146,8.5,100000,46241,92350,6782151,88800,7650,5000,11200,1
multi_pi-10-7500.csv,2,1687869539648,9,100000,36232,97350,6782151,93800,2650,5000,6200,1
multi_pi-10-7500.csv,2,1687869540165,9.5,100000,36200,100000,6782151,98800,0,5000,1200,1
multi_pi-10-7500.csv,1,1687869173977,0.0,0,5,0,6282151,0,0,7500,0,1
multi_pi-10-7500.csv,1,1687869174479,0.5,7100,7105,5150,6289251,5550,1950,7500,1550,1
multi_pi-10-7500.csv,1,1687869175068,1.1,13300,13305,13150,6295451,13150,150,7500,150,1
multi_pi-10-7500.csv,1,1687869175535,1.6,21600,21605,14300,6303751,21500,7300,7500,100,1
multi_pi-10-7500.csv,1,1687869175983,2.0,29100,29100,21800,6311251,27300,7300,7500,1800,1
multi_pi-10-7500.csv,1,1687869176489,2.5,37950,37950,21800,6320101,32350,16150,7500,5600,1
multi_pi-10-7500.csv,1,1687869176994,3.0,47700,47700,29300,6329851,32350,18400,7500,15350,1
multi_pi-10-7500.csv,1,1687869177483,3.5,54300,54300,36800,6336451,39850,17500,7500,14450,1
multi_pi-10-7500.csv,1,1687869178031,4.1,62750,61500,44300,6344901,39850,18450,7500,22900,1
multi_pi-10-7500.csv,1,1687869178484,4.5,72050,70800,44300,6354201,47350,27750,7500,24700,1
multi_pi-10-7500.csv,1,1687869178984,5.0,80850,79600,51800,6363001,47350,29050,7500,33500,1
multi_pi-10-7500.csv,1,1687869179518,5.5,89450,88200,51800,6371601,54850,37650,7500,34600,1
multi_pi-10-7500.csv,1,1687869180041,6.1,98900,97650,59300,6381051,54850,39600,7500,44050,1
multi_pi-10-7500.csv,1,1687869180485,6.5,100000,97997,59300,6382151,62350,40700,7500,37650,1
multi_pi-10-7500.csv,1,1687869180987,7.0,100000,97997,66800,6382151,69850,33200,7500,30150,1
multi_pi-10-7500.csv,1,1687869181537,7.6,100000,78550,74300,6382151,69850,25700,7500,30150,1
multi_pi-10-7500.csv,1,1687869181987,8.0,100000,78550,74300,6382151,77350,25700,7500,22650,1
multi_pi-10-7500.csv,1,1687869182496,8.5,100000,78550,81800,6382151,77350,18200,7500,22650,1
multi_pi-10-7500.csv,1,1687869182988,9.0,100000,70741,81800,6382151,84850,18200,7500,15150,1
multi_pi-10-7500.csv,1,1687869183487,9.5,100000,70741,96800,6382151,92350,3200,7500,7650,1
multi_pi-10-7500.csv,1,1687869183985,10.0,100000,70741,96800,6382151,92350,3200,7500,7650,1
multi_pi-10-7500.csv,1,1687869184489,10.5,100000,40743,100000,6382151,99850,0,7500,150,1
multi_pi-10-7500.csv,1,1687869184993,11.0,100000,37685,100000,6382151,100000,0,7500,0,1
multi_pi-10-7500.csv,3,1687869225006,0.0,0,4950,0,6482151,0,0,7500,0,1
multi_pi-10-7500.csv,3,1687869225521,0.5,4100,3550,4050,6486251,3200,50,7500,900,1
multi_pi-10-7500.csv,3,1687869226048,1.0,11900,9648,11750,6494051,8800,150,7500,3100,1
multi_pi-10-7500.csv,3,1687869226511,1.5,20000,14150,19850,6502151,19150,150,7500,850,1
multi_pi-10-7500.csv,3,1687869227003,2.0,30200,24350,25150,6512351,19150,5050,7500,11050,1
multi_pi-10-7500.csv,3,1687869227502,2.5,37500,31650,34950,6519651,34150,2550,7500,3350,1
multi_pi-10-7500.csv,3,1687869228011,3.0,44650,28316,34950,6526801,39300,9700,7500,5350,1
multi_pi-10-7500.csv,3,1687869228502,3.5,52200,35866,42450,6534351,39300,9750,7500,12900,1
multi_pi-10-7500.csv,3,1687869229111,4.1,63100,43996,49950,6545251,54300,13150,7500,8800,1
multi_pi-10-7500.csv,3,1687869229520,4.5,68200,49050,57450,6550351,61800,10750,7500,6400,1
multi_pi-10-7500.csv,3,1687869230032,5.0,76100,41200,64950,6558251,61800,11150,7500,14300,1
multi_pi-10-7500.csv,3,1687869230530,5.5,84750,49850,72450,6566901,69300,12300,7500,15450,1
multi_pi-10-7500.csv,3,1687869231005,6.0,94350,59450,72450,6576501,69300,21900,7500,25050,1
multi_pi-10-7500.csv,3,1687869231506,6.5,100000,65100,72450,6582151,69300,27550,7500,30700,1
multi_pi-10-7500.csv,3,1687869232039,7.0,100000,60910,87450,6582151,76800,12550,7500,23200,1
multi_pi-10-7500.csv,3,1687869232503,7.5,100000,60910,87450,6582151,84300,12550,7500,15700,1
multi_pi-10-7500.csv,3,1687869233037,8.0,100000,53237,87450,6582151,91800,12550,7500,8200,1
multi_pi-10-7500.csv,3,1687869233535,8.5,100000,53237,100000,6582151,91800,0,7500,8200,1
multi_pi-10-7500.csv,3,1687869234004,9.0,100000,53237,100000,6582151,99300,0,7500,700,1
multi_pi-10-7500.csv,3,1687869234507,9.5,100000,38246,100000,6582151,100000,0,7500,0,1
multi_pi-10-7500.csv,2,1687869197990,0.0,0,195,0,6382151,0,0,7500,0,1
multi_pi-10-7500.csv,2,1687869198493,0.5,5450,5100,4950,6387601,5100,500,7500,350,1
multi_pi-10-7500.csv,2,1687869198991,1.0,13250,10100,11350,6395401,11350,1900,7500,1900,1
multi_pi-10-7500.csv,2,1687869199491,1.5,20250,13950,19650,6402401,19900,600,7500,350,1
multi_pi-10-7500.csv,2,1687869200007,2.0,27800,20800,23300,6409951,27650,4500,7500,150,1
multi_pi-10-7500.csv,2,1687869200562,2.6,36700,26150,36550,6418851,36550,150,7500,150,1
multi_pi-10-7500.csv,2,1687869200994,3.0,42900,32350,40250,6425051,40200,2650,7500,2700,1
multi_pi-10-7500.csv,2,1687869201503,3.5,50300,34281,44500,6432451,50100,5800,7500,200,1
multi_pi-10-7500.csv,2,1687869201990,4.0,60100,44081,44500,6442251,50100,15600,7500,10000,1
multi_pi-10-7500.csv,2,1687869202544,4.6,67150,47250,59500,6449301,57600,7650,7500,9550,1
multi_pi-10-7500.csv,2,1687869203016,5.0,73000,49743,67000,6455151,65100,6000,7500,7900,1
multi_pi-10-7500.csv,2,1687869203494,5.5,80350,57093,67000,6462501,72600,13350,7500,7750,1
multi_pi-10-7500.csv,2,1687869203993,6.0,88150,64893,74500,6470301,72600,13650,7500,15550,1
multi_pi-10-7500.csv,2,1687869204518,6.5,97200,60685,74500,6479351,72600,22700,7500,24600,1
multi_pi-10-7500.csv,2,1687869204992,7.0,100000,63485,82000,6482151,87600,18000,7500,12400,1
multi_pi-10-7500.csv,2,1687869205493,7.5,100000,63485,89500,6482151,87600,10500,7500,12400,1
multi_pi-10-7500.csv,2,1687869205995,8.0,100000,63485,97000,6482151,87600,3000,7500,12400,1
multi_pi-10-7500.csv,2,1687869206510,8.5,100000,48050,97000,6482151,100000,3000,7500,0,1
multi_pi-10-7500.csv,2,1687869206996,9.0,100000,42443,100000,6482151,100000,0,7500,0,1
pi4_r1-3_10-7500.csv,3,1687860736632,0.0,0,41,0,6082151,0,0,7500,0,0
pi4_r1-3_10-7500.csv,3,1687860737136,0.5,8200,6983,5050,6090351,6750,3150,7500,1450,0
pi4_r1-3_10-7500.csv,3,1687860737646,1.0,18750,17068,14450,6100901,17200,4300,7500,1550,0
pi4_r1-3_10-7500.csv,3,1687860738135,1.5,29850,24831,21950,6112001,24700,7900,7500,5150,0
pi4_r1-3_10-7500.csv,3,1687860738634,2.0,42900,37881,21950,6125051,24700,20950,7500,18200,0
pi4_r1-3_10-7500.csv,3,1687860739139,2.5,53300,43699,29450,6135451,32200,23850,7500,21100,0
pi4_r1-3_10-7500.csv,3,1687860739636,3.0,66300,56615,29450,6148451,32200,36850,7500,34100,0
pi4_r1-3_10-7500.csv,3,1687860740136,3.5,77350,67665,36950,6159501,32200,40400,7500,45150,0
pi4_r1-3_10-7500.csv,3,1687860740643,4.0,90000,75600,36950,6172151,39700,53050,7500,50300,0
pi4_r1-3_10-7500.csv,3,1687860741139,4.5,100000,78100,44450,6182151,39700,55550,7500,60300,0
pi4_r1-3_10-7500.csv,3,1687860741636,5.0,100000,78100,44450,6182151,47200,55550,7500,52800,0
pi4_r1-3_10-7500.csv,3,1687860742149,5.5,100000,75350,51950,6182151,47200,48050,7500,52800,0
pi4_r1-3_10-7500.csv,3,1687860742635,6.0,100000,70552,51950,6182151,54700,48050,7500,45300,0
pi4_r1-3_10-7500.csv,3,1687860743141,6.5,100000,67812,59450,6182151,54700,40550,7500,45300,0
pi4_r1-3_10-7500.csv,3,1687860743639,7.0,100000,63096,59450,6182151,62200,40550,7500,37800,0
pi4_r1-3_10-7500.csv,3,1687860744149,7.5,100000,60350,66950,6182151,62200,33050,7500,37800,0
pi4_r1-3_10-7500.csv,3,1687860744638,8.0,100000,55566,66950,6182151,69700,33050,7500,30300,0
pi4_r1-3_10-7500.csv,3,1687860745138,8.5,100000,52829,74450,6182151,69700,25550,7500,30300,0
pi4_r1-3_10-7500.csv,3,1687860745639,9.0,100000,48077,74450,6182151,77200,25550,7500,22800,0
pi4_r1-3_10-7500.csv,3,1687860746142,9.5,100000,45349,81950,6182151,77200,18050,7500,22800,0
pi4_r1-3_10-7500.csv,3,1687860746638,10.0,100000,40600,81950,6182151,84700,18050,7500,15300,0
pi4_r1-3_10-7500.csv,3,1687860747140,10.5,100000,37849,89450,6182151,84700,10550,7500,15300,0
pi4_r1-3_10-7500.csv,3,1687860747639,11.0,100000,33083,89450,6182151,92200,10550,7500,7800,0
pi4_r1-3_10-7500.csv,3,1687860748147,11.5,100000,33083,89450,6182151,92200,10550,7500,7800,0
pi4_r1-3_10-7500.csv,3,1687860748639,12.0,100000,25555,96950,6182151,99700,3050,7500,300,0
pi4_r1-3_10-7500.csv,3,1687860749139,12.5,100000,22849,100000,6182151,99700,0,7500,300,0
pi4_r1-3_10-7500.csv,2,1687860703624,0.0,0,50,0,5982151,0,0,7500,0,0
pi4_r1-3_10-7500.csv,2,1687860704123,0.5,6500,6041,4300,5988651,5450,2200,7500,1050,0
pi4_r1-3_10-7500.csv,2,1687860704623,1.0,18800,17427,13000,6000951,11850,5800,7500,6950,0
pi4_r1-3_10-7500.csv,2,1687860705124,1.5,31550,28960,20500,6013701,19350,11050,7500,12200,0
pi4_r1-3_10-7500.csv,2,1687860705625,2.0,44950,42360,28000,6027101,19350,16950,7500,25600,0
pi4_r1-3_10-7500.csv,2,1687860706125,2.5,56250,52000,28000,6038401,26850,28250,7500,29400,0
pi4_r1-3_10-7500.csv,2,1687860706624,3.0,70700,65259,28000,6052851,26850,42700,7500,43850,0
pi4_r1-3_10-7500.csv,2,1687860707129,3.5,80900,69061,35500,6063051,34350,45400,7500,46550,0
pi4_r1-3_10-7500.csv,2,1687860707632,4.0,95000,83161,35500,6077151,34350,59500,7500,60650,0
pi4_r1-3_10-7500.csv,2,1687860708123,4.5,100000,80700,43000,6082151,41850,57000,7500,58150,0
pi4_r1-3_10-7500.csv,2,1687860708622,5.0,100000,80700,43000,6082151,41850,57000,7500,58150,0
pi4_r1-3_10-7500.csv,2,1687860709130,5.5,100000,72010,50500,6082151,49350,49500,7500,50650,0
pi4_r1-3_10-7500.csv,2,1687860709625,6.0,100000,72010,50500,6082151,49350,49500,7500,50650,0
pi4_r1-3_10-7500.csv,2,1687860710134,6.5,100000,65655,58000,6082151,49350,42000,7500,50650,0
pi4_r1-3_10-7500.csv,2,1687860710624,7.0,100000,65655,58000,6082151,56850,42000,7500,43150,0
pi4_r1-3_10-7500.csv,2,1687860711128,7.5,100000,65655,65500,6082151,56850,34500,7500,43150,0
pi4_r1-3_10-7500.csv,2,1687860711625,8.0,100000,58168,65500,6082151,64350,34500,7500,35650,0
pi4_r1-3_10-7500.csv,2,1687860712143,8.5,100000,50673,73000,6082151,71850,27000,7500,28150,0
pi4_r1-3_10-7500.csv,2,1687860712625,9.0,100000,50673,73000,6082151,71850,27000,7500,28150,0
pi4_r1-3_10-7500.csv,2,1687860713129,9.5,100000,43162,80500,6082151,79350,19500,7500,20650,0
pi4_r1-3_10-7500.csv,2,1687860713626,10.0,100000,43162,80500,6082151,79350,19500,7500,20650,0
pi4_r1-3_10-7500.csv,2,1687860714127,10.5,100000,43162,88000,6082151,86850,12000,7500,13150,0
pi4_r1-3_10-7500.csv,2,1687860714626,11.0,100000,43162,88000,6082151,86850,12000,7500,13150,0
pi4_r1-3_10-7500.csv,2,1687860715160,11.5,100000,28200,88000,6082151,94350,12000,7500,5650,0
pi4_r1-3_10-7500.csv,2,1687860715627,12.0,100000,28200,95500,6082151,94350,4500,7500,5650,0
pi4_r1-3_10-7500.csv,2,1687860716128,12.5,100000,20670,95500,6082151,100000,4500,7500,0,0
pi4_r1-3_10-7500.csv,2,1687860716627,13.0,100000,20670,100000,6082151,100000,0,7500,0,0
pi4_r1-3_10-7500.csv,1,1687860671613,0.0,0,33,0,5882151,0,0,7500,0,0
pi4_r1-3_10-7500.csv,1,1687860672114,0.5,1600,1633,900,5883751,850,700,7500,750,0
pi4_r1-3_10-7500.csv,1,1687860672613,1.0,10850,10883,9650,5893001,7250,1200,7500,3600,0
pi4_r1-3_10-7500.csv,1,1687860673147,1.5,21250,21283,17150,5903401,18850,4100,7500,2400,0
pi4_r1-3_10-7500.csv,1,1687860673614,2.0,31900,31933,17150,5914051,18850,14750,7500,13050,0
pi4_r1-3_10-7500.csv,1,1687860674113,2.5,45150,45183,17150,5927301,18850,28000,7500,26300,0
pi4_r1-3_10-7500.csv,1,1687860674613,3.0,57550,57583,17150,5939701,26350,40400,7500,31200,0
pi4_r1-3_10-7500.csv,1,1687860675116,3.5,70300,70333,24650,5952451,26350,45650,7500,43950,0
pi4_r1-3_10-7500.csv,1,1687860675615,4.0,81850,81883,24650,5964001,33850,57200,7500,48000,0
pi4_r1-3_10-7500.csv,1,1687860676114,4.5,95300,95333,24650,5977451,33850,70650,7500,61450,0
pi4_r1-3_10-7500.csv,1,1687860676649,5.0,100000,100033,24650,5982151,41350,75350,7500,58650,0
pi4_r1-3_10-7500.csv,1,1687860677154,5.5,100000,82857,32150,5982151,41350,67850,7500,58650,0
pi4_r1-3_10-7500.csv,1,1687860677615,6.0,100000,81163,39650,5982151,41350,60350,7500,58650,0
pi4_r1-3_10-7500.csv,1,1687860678117,6.5,100000,75400,39650,5982151,48850,60350,7500,51150,0
pi4_r1-3_10-7500.csv,1,1687860678615,7.0,100000,75400,47150,5982151,48850,52850,7500,51150,0
pi4_r1-3_10-7500.csv,1,1687860679116,7.5,100000,75400,47150,5982151,56350,52850,7500,43650,0
pi4_r1-3_10-7500.csv,1,1687860679623,8.0,100000,66200,54650,5982151,56350,45350,7500,43650,0
pi4_r1-3_10-7500.csv,1,1687860680119,8.5,100000,60400,54650,5982151,63850,45350,7500,36150,0
pi4_r1-3_10-7500.csv,1,1687860680618,9.0,100000,60400,62150,5982151,63850,37850,7500,36150,0
pi4_r1-3_10-7500.csv,1,1687860681117,9.5,100000,60400,62150,5982151,71350,37850,7500,28650,0
pi4_r1-3_10-7500.csv,1,1687860681619,10.0,100000,51190,69650,5982151,71350,30350,7500,28650,0
pi4_r1-3_10-7500.csv,1,1687860682118,10.5,100000,45400,69650,5982151,78850,30350,7500,21150,0
pi4_r1-3_10-7500.csv,1,1687860682620,11.0,100000,45400,77150,5982151,78850,22850,7500,21150,0
pi4_r1-3_10-7500.csv,1,1687860683117,11.5,100000,45400,77150,5982151,86350,22850,7500,13650,0
pi4_r1-3_10-7500.csv,1,1687860683628,12.0,100000,37899,84650,5982151,86350,15350,7500,13650,0
pi4_r1-3_10-7500.csv,1,1687860684142,12.5,100000,37899,84650,5982151,93850,15350,7500,6150,0
pi4_r1-3_10-7500.csv,1,1687860684619,13.0,100000,30378,84650,5982151,93850,15350,7500,6150,0
pi4_r1-3_10-7500.csv,1,1687860685118,13.5,100000,30378,92150,5982151,100000,7850,7500,0,0
pi4_r1-3_10-7500.csv,1,1687860685618,14.0,100000,30378,92150,5982151,100000,7850,7500,0,0
pi4_r1-3_10-7500.csv,1,1687860686119,14.5,100000,22870,99650,5982151,100000,350,7500,0,0
pi4_r1-3_10-7500.csv,1,1687860686619,15.0,100000,22870,99650,5982151,100000,350,7500,0,0
pi4_r1-3_10-7500.csv,1,1687860687123,15.5,100000,15399,100000,5982151,100000,0,7500,0,0
pi4_r1-3_10-7500.csv,3,1687860412584,0.0,0,34,0,5782151,0,0,5000,0,0
pi4_r1-3_10-7500.csv,3,1687860413088,0.5,2900,2934,1500,5785051,2550,1400,5000,350,0
pi4_r1-3_10-7500.csv,3,1687860413614,1.0,12350,12384,10300,5794501,9950,2050,5000,2400,0
pi4_r1-3_10-7500.csv,3,1687860414086,1.5,24400,24434,10300,5806551,9950,14100,5000,14450,0
pi4_r1-3_10-7500.csv,3,1687860414586,2.0,36350,36384,15300,5818501,14950,21050,5000,21400,0
pi4_r1-3_10-7500.csv,3,1687860415087,2.5,49700,49734,15300,5831851,14950,34400,5000,34750,0
pi4_r1-3_10-7500.csv,3,1687860415586,3.0,61600,61634,15300,5843751,19950,46300,5000,41650,0
pi4_r1-3_10-7500.csv,3,1687860416085,3.5,75550,75584,15300,5857701,24950,60250,5000,50600,0
pi4_r1-3_10-7500.csv,3,1687860416588,4.0,88750,88784,20300,5870901,24950,68450,5000,63800,0
pi4_r1-3_10-7500.csv,3,1687860417084,4.5,100000,100034,20300,5882151,29950,79700,5000,70050,0
pi4_r1-3_10-7500.csv,3,1687860417586,5.0,100000,99342,25300,5882151,34950,74700,5000,65050,0
pi4_r1-3_10-7500.csv,3,1687860418084,5.5,100000,99342,25300,5882151,39950,74700,5000,60050,0
pi4_r1-3_10-7500.csv,3,1687860418586,6.0,100000,99342,25300,5882151,39950,74700,5000,60050,0
pi4_r1-3_10-7500.csv,3,1687860419089,6.5,100000,74741,35300,5882151,44950,64700,5000,55050,0
pi4_r1-3_10-7500.csv,3,1687860419587,7.0,100000,74741,40300,5882151,49950,59700,5000,50050,0
pi4_r1-3_10-7500.csv,3,1687860420086,7.5,100000,74741,40300,5882151,54950,59700,5000,45050,0
pi4_r1-3_10-7500.csv,3,1687860420587,8.0,100000,74741,45300,5882151,54950,54700,5000,45050,0
pi4_r1-3_10-7500.csv,3,1687860421088,8.5,100000,64713,50300,5882151,59950,49700,5000,40050,0
pi4_r1-3_10-7500.csv,3,1687860421589,9.0,100000,59723,55300,5882151,64950,44700,5000,35050,0
pi4_r1-3_10-7500.csv,3,1687860422087,9.5,100000,59723,55300,5882151,69950,44700,5000,30050,0
pi4_r1-3_10-7500.csv,3,1687860422588,10.0,100000,54746,60300,5882151,69950,39700,5000,30050,0
pi4_r1-3_10-7500.csv,3,1687860423088,10.5,100000,54746,65300,5882151,74950,34700,5000,25050,0
pi4_r1-3_10-7500.csv,3,1687860423606,11.0,100000,54746,70300,5882151,79950,29700,5000,20050,0
pi4_r1-3_10-7500.csv,3,1687860424086,11.5,100000,54746,70300,5882151,79950,29700,5000,20050,0
pi4_r1-3_10-7500.csv,3,1687860424589,12.0,100000,39738,75300,5882151,84950,24700,5000,15050,0
pi4_r1-3_10-7500.csv,3,1687860425088,12.5,100000,39738,80300,5882151,89950,19700,5000,10050,0
pi4_r1-3_10-7500.csv,3,1687860425607,13.0,100000,29713,85300,5882151,94950,14700,5000,5050,0
pi4_r1-3_10-7500.csv,3,1687860426088,13.5,100000,29713,85300,5882151,99950,14700,5000,50,0
pi4_r1-3_10-7500.csv,3,1687860426589,14.0,100000,24750,90300,5882151,99950,9700,5000,50,0
pi4_r1-3_10-7500.csv,3,1687860427091,14.5,100000,19750,95300,5882151,100000,4700,5000,0,0
pi4_r1-3_10-7500.csv,3,1687860427590,15.0,100000,19750,95300,5882151,100000,4700,5000,0,0
pi4_r1-3_10-7500.csv,3,1687860428089,15.5,100000,14746,100000,5882151,100000,0,5000,0,0
pi4_r1-3_10-7500.csv,2,1687860057427,0.0,0,50,0,5682151,0,0,5000,0,0
pi4_r1-3_10-7500.csv,2,1687860057927,0.5,9800,9253,7850,5691951,6000,1950,5000,3800,0
pi4_r1-3_10-7500.csv,2,1687860058430,1.0,21700,19887,12850,5703851,16000,8850,5000,5700,0
pi4_r1-3_10-7500.csv,2,1687860058930,1.5,36450,34637,12850,5718601,16000,23600,5000,20450,0
pi4_r1-3_10-7500.csv,2,1687860059428,2.0,49100,46096,17850,5731251,21000,31250,5000,28100,0
pi4_r1-3_10-7500.csv,2,1687860059928,2.5,61550,58546,22850,5743701,26000,38700,5000,35550,0
pi4_r1-3_10-7500.csv,2,1687860060428,3.0,74850,71846,22850,5757001,31000,52000,5000,43850,0
pi4_r1-3_10-7500.csv,2,1687860060946,3.5,87200,74360,27850,5769351,36000,59350,5000,51200,0
pi4_r1-3_10-7500.csv,2,1687860061427,4.0,100000,87160,27850,5782151,36000,72150,5000,64000,0
pi4_r1-3_10-7500.csv,2,1687860061929,4.5,100000,82200,32850,5782151,41000,67150,5000,59000,0
pi4_r1-3_10-7500.csv,2,1687860062430,5.0,100000,77200,37850,5782151,46000,62150,5000,54000,0
pi4_r1-3_10-7500.csv,2,1687860062929,5.5,100000,72171,42850,5782151,51000,57150,5000,49000,0
pi4_r1-3_10-7500.csv,2,1687860063429,6.0,100000,72171,42850,5782151,51000,57150,5000,49000,0
pi4_r1-3_10-7500.csv,2,1687860063929,6.5,100000,67196,47850,5782151,56000,52150,5000,44000,0
pi4_r1-3_10-7500.csv,2,1687860064431,7.0,100000,62200,52850,5782151,61000,47150,5000,39000,0
pi4_r1-3_10-7500.csv,2,1687860064930,7.5,100000,62200,52850,5782151,61000,47150,5000,39000,0
pi4_r1-3_10-7500.csv,2,1687860065431,8.0,100000,57200,57850,5782151,66000,42150,5000,34000,0
pi4_r1-3_10-7500.csv,2,1687860065936,8.5,100000,52156,62850,5782151,71000,37150,5000,29000,0
pi4_r1-3_10-7500.csv,2,1687860066452,9.0,100000,47188,67850,5782151,76000,32150,5000,24000,0
pi4_r1-3_10-7500.csv,2,1687860066933,9.5,100000,47188,67850,5782151,76000,32150,5000,24000,0
pi4_r1-3_10-7500.csv,2,1687860067432,10.0,100000,42200,72850,5782151,81000,27150,5000,19000,0
pi4_r1-3_10-7500.csv,2,1687860067932,10.5,100000,37188,77850,5782151,86000,22150,5000,14000,0
pi4_r1-3_10-7500.csv,2,1687860068435,11.0,100000,32158,82850,5782151,91000,17150,5000,9000,0
pi4_r1-3_10-7500.csv,2,1687860068934,11.5,100000,32158,82850,5782151,91000,17150,5000,9000,0
pi4_r1-3_10-7500.csv,2,1687860069431,12.0,100000,32158,87850,5782151,96000,12150,5000,4000,0
pi4_r1-3_10-7500.csv,2,1687860069931,12.5,100000,22170,92850,5782151,100000,7150,5000,0,0
pi4_r1-3_10-7500.csv,2,1687860070432,13.0,100000,22170,97850,5782151,100000,2150,5000,0,0
pi4_r1-3_10-7500.csv,2,1687860070933,13.5,100000,17200,100000,5782151,100000,0,5000,0,0
pi4_r1-3_10-7500.csv,1,1687860029415,0.0,0,46,0,5582151,0,0,5000,0,0
pi4_r1-3_10-7500.csv,1,1687860029938,0.5,7650,7696,3750,5589801,7650,3900,5000,0,0
pi4_r1-3_10-7500.csv,1,1687860030415,1.0,16800,16846,8750,5598951,12650,8050,5000,4150,0
pi4_r1-3_10-7500.csv,1,1687860030919,1.5,27350,27396,13750,5609501,12650,13600,5000,14700,0
pi4_r1-3_10-7500.csv,1,1687860031414,2.0,39750,39796,13750,5621901,12650,26000,5000,27100,0
pi4_r1-3_10-7500.csv,1,1687860031918,2.5,51550,51596,13750,5633701,17650,37800,5000,33900,0
pi4_r1-3_10-7500.csv,1,1687860032414,3.0,63650,63696,18750,5645801,17650,44900,5000,46000,0
pi4_r1-3_10-7500.csv,1,1687860032924,3.5,74250,74150,23750,5656401,22650,50500,5000,51600,0
pi4_r1-3_10-7500.csv,1,1687860033415,4.0,85900,85516,23750,5668051,22650,62150,5000,63250,0
pi4_r1-3_10-7500.csv,1,1687860033917,4.5,99400,99016,28750,5681551,22650,70650,5000,76750,0
pi4_r1-3_10-7500.csv,1,1687860034421,5.0,100000,81295,33750,5682151,32650,66250,5000,67350,0
pi4_r1-3_10-7500.csv,1,1687860034918,5.5,100000,77400,38750,5682151,37650,61250,5000,62350,0
pi4_r1-3_10-7500.csv,1,1687860035425,6.0,100000,77400,38750,5682151,42650,61250,5000,57350,0
pi4_r1-3_10-7500.csv,1,1687860035916,6.5,100000,77400,43750,5682151,42650,56250,5000,57350,0
pi4_r1-3_10-7500.csv,1,1687860036418,7.0,100000,67361,48750,5682151,47650,51250,5000,52350,0
pi4_r1-3_10-7500.csv,1,1687860036922,7.5,100000,62400,53750,5682151,52650,46250,5000,47350,0
pi4_r1-3_10-7500.csv,1,1687860037416,8.0,100000,62400,53750,5682151,52650,46250,5000,47350,0
pi4_r1-3_10-7500.csv,1,1687860037917,8.5,100000,57389,58750,5682151,57650,41250,5000,42350,0
pi4_r1-3_10-7500.csv,1,1687860038426,9.0,100000,52364,63750,5682151,62650,36250,5000,37350,0
pi4_r1-3_10-7500.csv,1,1687860038925,9.5,100000,52364,68750,5682151,67650,31250,5000,32350,0
pi4_r1-3_10-7500.csv,1,1687860039420,10.0,100000,52364,68750,5682151,67650,31250,5000,32350,0
pi4_r1-3_10-7500.csv,1,1687860039924,10.5,100000,47396,73750,5682151,72650,26250,5000,27350,0
pi4_r1-3_10-7500.csv,1,1687860040420,11.0,100000,42400,78750,5682151,77650,21250,5000,22350,0
pi4_r1-3_10-7500.csv,1,1687860040923,11.5,100000,32369,83750,5682151,82650,16250,5000,17350,0
pi4_r1-3_10-7500.csv,1,1687860041425,12.0,100000,32369,83750,5682151,82650,16250,5000,17350,0
pi4_r1-3_10-7500.csv,1,1687860041920,12.5,100000,27395,88750,5682151,87650,11250,5000,12350,0
pi4_r1-3_10-7500.csv,1,1687860042423,13.0,100000,22384,93750,5682151,92650,6250,5000,7350,0
pi4_r1-3_10-7500.csv,1,1687860042922,13.5,100000,17362,98750,5682151,97650,1250,5000,2350,0
pi4_r1-3_10-7500.csv,1,1687860043422,14.0,100000,17362,100000,5682151,97650,0,5000,2350,0
pi4_r1-3_10-7500.csv,3,1687859786256,0.0,0,48,0,5482151,0,0,2500,0,0
pi4_r1-3_10-7500.csv,3,1687859786754,0.5,2600,2500,2350,5484751,2350,250,2500,250,0
pi4_r1-3_10-7500.csv,3,1687859787277,1.0,12150,9822,8700,5494301,8700,3450,2500,3450,0
pi4_r1-3_10-7500.csv,3,1687859787765,1.5,22450,20122,11200,5504601,11200,11250,2500,11250,0
pi4_r1-3_10-7500.csv,3,1687859788273,2.0,34850,26190,16200,5517001,16200,18650,2500,18650,0
pi4_r1-3_10-7500.csv,3,1687859788761,2.5,47900,39240,18700,5530051,16200,29200,2500,31700,0
pi4_r1-3_10-7500.csv,3,1687859789272,3.0,61250,47591,23700,5543401,21200,37550,2500,40050,0
pi4_r1-3_10-7500.csv,3,1687859789758,3.5,72650,58991,26200,5554801,23700,46450,2500,48950,0
pi4_r1-3_10-7500.csv,3,1687859790258,4.0,85050,66366,28700,5567201,26200,56350,2500,58850,0
pi4_r1-3_10-7500.csv,3,1687859790801,4.5,98650,79966,33700,5580801,28700,64950,2500,69950,0
pi4_r1-3_10-7500.csv,3,1687859791263,5.0,100000,76350,36200,5582151,31200,63800,2500,68800,0
pi4_r1-3_10-7500.csv,3,1687859791762,5.5,100000,71322,41200,5582151,36200,58800,2500,63800,0
pi4_r1-3_10-7500.csv,3,1687859792265,6.0,100000,66347,43700,5582151,41200,56300,2500,58800,0
pi4_r1-3_10-7500.csv,3,1687859792763,6.5,100000,61346,48700,5582151,43700,51300,2500,56300,0
pi4_r1-3_10-7500.csv,3,1687859793274,7.0,100000,58850,53700,5582151,48700,46300,2500,51300,0
pi4_r1-3_10-7500.csv,3,1687859793765,7.5,100000,56348,56200,5582151,51200,43800,2500,48800,0
pi4_r1-3_10-7500.csv,3,1687859794263,8.0,100000,51350,61200,5582151,56200,38800,2500,43800,0
pi4_r1-3_10-7500.csv,3,1687859794765,8.5,100000,48816,63700,5582151,58700,36300,2500,41300,0
pi4_r1-3_10-7500.csv,3,1687859795264,9.0,100000,43849,68700,5582151,63700,31300,2500,36300,0
pi4_r1-3_10-7500.csv,3,1687859795764,9.5,100000,41323,71200,5582151,66200,28800,2500,33800,0
pi4_r1-3_10-7500.csv,3,1687859796264,10.0,100000,36325,73700,5582151,71200,26300,2500,28800,0
pi4_r1-3_10-7500.csv,3,1687859796765,10.5,100000,33850,78700,5582151,73700,21300,2500,26300,0
pi4_r1-3_10-7500.csv,3,1687859797274,11.0,100000,28849,81200,5582151,78700,18800,2500,21300,0
pi4_r1-3_10-7500.csv,3,1687859797769,11.5,100000,26350,86200,5582151,81200,13800,2500,18800,0
pi4_r1-3_10-7500.csv,3,1687859798267,12.0,100000,21341,88700,5582151,86200,11300,2500,13800,0
pi4_r1-3_10-7500.csv,3,1687859798775,12.5,100000,18844,93700,5582151,91200,6300,2500,8800,0
pi4_r1-3_10-7500.csv,3,1687859799266,13.0,100000,13850,98700,5582151,93700,1300,2500,6300,0
pi4_r1-3_10-7500.csv,3,1687859799768,13.5,100000,8810,100000,5582151,98700,0,2500,1300,0
pi4_r1-3_10-7500.csv,2,1687859736734,0.0,0,50,0,5382151,0,0,2500,0,0
pi4_r1-3_10-7500.csv,2,1687859737245,0.5,3900,3851,3800,5386051,3700,100,2500,200,0
pi4_r1-3_10-7500.csv,2,1687859737734,1.0,16250,15277,6300,5398401,8700,9950,2500,7550,0
pi4_r1-3_10-7500.csv,2,1687859738248,1.5,30100,26425,11300,5412251,13700,18800,2500,16400,0
pi4_r1-3_10-7500.csv,2,1687859738734,2.0,43850,37576,13800,5426001,16200,30050,2500,27650,0
pi4_r1-3_10-7500.csv,2,1687859739234,2.5,55550,49276,16300,5437701,18700,39250,2500,36850,0
pi4_r1-3_10-7500.csv,2,1687859739735,3.0,68250,57000,18800,5450401,23700,49450,2500,44550,0
pi4_r1-3_10-7500.csv,2,1687859740235,3.5,80450,66652,21300,5462601,26200,59150,2500,54250,0
pi4_r1-3_10-7500.csv,2,1687859740740,4.0,93150,76895,23800,5475301,31200,69350,2500,61950,0
pi4_r1-3_10-7500.csv,2,1687859741235,4.5,100000,81203,26300,5482151,36200,73700,2500,63800,0
pi4_r1-3_10-7500.csv,2,1687859741742,5.0,100000,78749,28800,5482151,38700,71200,2500,61300,0
pi4_r1-3_10-7500.csv,2,1687859742236,5.5,100000,73724,33800,5482151,43700,66200,2500,56300,0
pi4_r1-3_10-7500.csv,2,1687859742735,6.0,100000,71250,38800,5482151,46200,61200,2500,53800,0
pi4_r1-3_10-7500.csv,2,1687859743237,6.5,100000,66250,41300,5482151,51200,58700,2500,48800,0
pi4_r1-3_10-7500.csv,2,1687859743737,7.0,100000,66250,46300,5482151,53700,53700,2500,46300,0
pi4_r1-3_10-7500.csv,2,1687859744238,7.5,100000,58750,48800,5482151,58700,51200,2500,41300,0
pi4_r1-3_10-7500.csv,2,1687859744736,8.0,100000,53750,53800,5482151,61200,46200,2500,38800,0
pi4_r1-3_10-7500.csv,2,1687859745246,8.5,100000,48720,58800,5482151,66200,41200,2500,33800,0
pi4_r1-3_10-7500.csv,2,1687859745736,9.0,100000,46229,61300,5482151,68700,38700,2500,31300,0
pi4_r1-3_10-7500.csv,2,1687859746236,9.5,100000,46229,66300,5482151,73700,33700,2500,26300,0
pi4_r1-3_10-7500.csv,2,1687859746737,10.0,100000,41210,68800,5482151,76200,31200,2500,23800,0
pi4_r1-3_10-7500.csv,2,1687859747238,10.5,100000,33718,73800,5482151,81200,26200,2500,18800,0
pi4_r1-3_10-7500.csv,2,1687859747736,11.0,100000,31246,76300,5482151,86200,23700,2500,13800,0
pi4_r1-3_10-7500.csv,2,1687859748237,11.5,100000,28706,81300,5482151,88700,18700,2500,11300,0
pi4_r1-3_10-7500.csv,2,1687859748738,12.0,100000,23721,83800,5482151,93700,16200,2500,6300,0
pi4_r1-3_10-7500.csv,2,1687859749239,12.5,100000,18704,88800,5482151,96200,11200,2500,3800,0
pi4_r1-3_10-7500.csv,2,1687859749739,13.0,100000,16235,91300,5482151,100000,8700,2500,0,0
pi4_r1-3_10-7500.csv,2,1687859750237,13.5,100000,11215,96300,5482151,100000,3700,2500,0,0
pi4_r1-3_10-7500.csv,2,1687859750738,14.0,100000,8715,100000,5482151,100000,0,2500,0,0
pi4_r1-3_10-7500.csv,1,1687859641693,0.0,0,44,0,5282151,0,0,2500,0,0
pi4_r1-3_10-7500.csv,1,1687859642193,0.5,7900,7944,4900,5290051,2400,3000,2500,5500,0
pi4_r1-3_10-7500.csv,1,1687859642693,1.0,18200,18244,9900,5300351,7400,8300,2500,10800,0
pi4_r1-3_10-7500.csv,1,1687859643195,1.5,31000,31044,9900,5313151,7400,21100,2500,23600,0
pi4_r1-3_10-7500.csv,1,1687859643701,2.0,42750,42794,12400,5324901,9900,30350,2500,32850,0
pi4_r1-3_10-7500.csv,1,1687859644201,2.5,56300,56344,14900,5338451,9900,41400,2500,46400,0
pi4_r1-3_10-7500.csv,1,1687859644694,3.0,67550,67300,17400,5349701,12400,50150,2500,55150,0
pi4_r1-3_10-7500.csv,1,1687859645198,3.5,78100,70750,22400,5360251,14900,55700,2500,63200,0
pi4_r1-3_10-7500.csv,1,1687859645693,4.0,91250,81396,24900,5373401,17400,66350,2500,73850,0
pi4_r1-3_10-7500.csv,1,1687859646196,4.5,100000,87650,29900,5382151,19900,70100,2500,80100,0
pi4_r1-3_10-7500.csv,1,1687859646696,5.0,100000,82649,32400,5382151,24900,67600,2500,75100,0
pi4_r1-3_10-7500.csv,1,1687859647193,5.5,100000,80150,37400,5382151,27400,62600,2500,72600,0
pi4_r1-3_10-7500.csv,1,1687859647695,6.0,100000,75149,39900,5382151,32400,60100,2500,67600,0
pi4_r1-3_10-7500.csv,1,1687859648195,6.5,100000,72602,44900,5382151,34900,55100,2500,65100,0
pi4_r1-3_10-7500.csv,1,1687859648694,7.0,100000,67602,47400,5382151,39900,52600,2500,60100,0
pi4_r1-3_10-7500.csv,1,1687859649195,7.5,100000,65150,52400,5382151,42400,47600,2500,57600,0
pi4_r1-3_10-7500.csv,1,1687859649694,8.0,100000,60147,54900,5382151,47400,45100,2500,52600,0
pi4_r1-3_10-7500.csv,1,1687859650195,8.5,100000,55118,59900,5382151,52400,40100,2500,47600,0
pi4_r1-3_10-7500.csv,1,1687859650695,9.0,100000,52649,62400,5382151,54900,37600,2500,45100,0
pi4_r1-3_10-7500.csv,1,1687859651195,9.5,100000,47650,67400,5382151,59900,32600,2500,40100,0
pi4_r1-3_10-7500.csv,1,1687859651694,10.0,100000,47650,69900,5382151,62400,30100,2500,37600,0
pi4_r1-3_10-7500.csv,1,1687859652200,10.5,100000,42641,74900,5382151,64900,25100,2500,35100,0
pi4_r1-3_10-7500.csv,1,1687859652699,11.0,100000,37650,77400,5382151,69900,22600,2500,30100,0
pi4_r1-3_10-7500.csv,1,1687859653214,11.5,100000,32648,82400,5382151,74900,17600,2500,25100,0
pi4_r1-3_10-7500.csv,1,1687859653696,12.0,100000,30137,84900,5382151,77400,15100,2500,22600,0
pi4_r1-3_10-7500.csv,1,1687859654197,12.5,100000,25141,87400,5382151,82400,12600,2500,17600,0
pi4_r1-3_10-7500.csv,1,1687859654699,13.0,100000,22602,92400,5382151,84900,7600,2500,15100,0
pi4_r1-3_10-7500.csv,1,1687859655200,13.5,100000,20131,97400,5382151,89900,2600,2500,10100,0
pi4_r1-3_10-7500.csv,1,1687859655704,14.0,100000,17637,99900,5382151,92400,100,2500,7600,0
pi4_r1-3_10-7500.csv,1,1687859656199,14.5,100000,12646,100000,5382151,97400,0,2500,2600,0
pi4_r1-3_10-7500.csv,3,1687859250091,0.0,0,50,0,5182151,0,0,1000,0,0
pi4_r1-3_10-7500.csv,3,1687859250591,0.5,1700,1693,1050,5183851,1350,650,1000,350,0
pi4_r1-3_10-7500.csv,3,1687859251090,1.0,13350,11350,6050,5195501,4250,7300,1000,9100,0
pi4_r1-3_10-7500.csv,3,1687859251592,1.5,26600,22388,10050,5208751,7250,16550,1000,19350,0
pi4_r1-3_10-7500.csv,3,1687859252092,2.0,40400,34200,14050,5222551,10250,26350,1000,30150,0
pi4_r1-3_10-7500.csv,3,1687859252592,2.5,53200,43952,18050,5235351,13250,35150,1000,39950,0
pi4_r1-3_10-7500.csv,3,1687859253097,3.0,65950,52750,22050,5248101,16250,43900,1000,49700,0
pi4_r1-3_10-7500.csv,3,1687859253592,3.5,78650,63430,26050,5260801,19250,52600,1000,59400,0
pi4_r1-3_10-7500.csv,3,1687859254092,4.0,90550,71335,29050,5272701,22250,61500,1000,68300,0
pi4_r1-3_10-7500.csv,3,1687859254591,4.5,100000,78798,33050,5282151,24250,66950,1000,75750,0
pi4_r1-3_10-7500.csv,3,1687859255091,5.0,100000,75800,36050,5282151,27250,63950,1000,72750,0
pi4_r1-3_10-7500.csv,3,1687859255591,5.5,100000,71799,40050,5282151,31250,59950,1000,68750,0
pi4_r1-3_10-7500.csv,3,1687859256091,6.0,100000,67800,43050,5282151,35250,56950,1000,64750,0
pi4_r1-3_10-7500.csv,3,1687859256598,6.5,100000,62774,47050,5282151,40250,52950,1000,59750,0
pi4_r1-3_10-7500.csv,3,1687859257100,7.0,100000,59796,51050,5282151,44250,48950,1000,55750,0
pi4_r1-3_10-7500.csv,3,1687859257595,7.5,100000,54774,55050,5282151,48250,44950,1000,51750,0
pi4_r1-3_10-7500.csv,3,1687859258093,8.0,100000,50765,59050,5282151,52250,40950,1000,47750,0
pi4_r1-3_10-7500.csv,3,1687859258592,8.5,100000,46796,63050,5282151,56250,36950,1000,43750,0
pi4_r1-3_10-7500.csv,3,1687859259093,9.0,100000,42793,67050,5282151,60250,32950,1000,39750,0
pi4_r1-3_10-7500.csv,3,1687859259592,9.5,100000,38800,71050,5282151,64250,28950,1000,35750,0
pi4_r1-3_10-7500.csv,3,1687859260095,10.0,100000,34781,75050,5282151,68250,24950,1000,31750,0
pi4_r1-3_10-7500.csv,3,1687859260605,10.5,100000,30800,80050,5282151,72250,19950,1000,27750,0
pi4_r1-3_10-7500.csv,3,1687859261093,11.0,100000,27776,84050,5282151,76250,15950,1000,23750,0
pi4_r1-3_10-7500.csv,3,1687859261594,11.5,100000,23800,87050,5282151,80250,12950,1000,19750,0
pi4_r1-3_10-7500.csv,3,1687859262122,12.0,100000,19759,91050,5282151,83250,8950,1000,16750,0
pi4_r1-3_10-7500.csv,3,1687859262599,12.5,100000,18800,95050,5282151,85250,4950,1000,14750,0
pi4_r1-3_10-7500.csv,3,1687859263095,13.0,100000,13800,97050,5282151,89250,2950,1000,10750,0
pi4_r1-3_10-7500.csv,3,1687859263594,13.5,100000,8792,100000,5282151,94250,0,1000,5750,0
pi4_r1-3_10-7500.csv,2,1687859221582,0.0,0,46,0,5082151,0,0,1000,0,0
pi4_r1-3_10-7500.csv,2,1687859222082,0.5,4550,4546,3200,5086701,2350,1350,1000,2200,0
pi4_r1-3_10-7500.csv,2,1687859222583,1.0,17750,16373,7200,5099901,5350,10550,1000,12400,0
pi4_r1-3_10-7500.csv,2,1687859223083,1.5,31500,27200,11200,5113651,8350,20300,1000,23150,0
pi4_r1-3_10-7500.csv,2,1687859223584,2.0,45350,38050,14200,5127501,11350,31150,1000,34000,0
pi4_r1-3_10-7500.csv,2,1687859224085,2.5,58850,48541,18200,5141001,14350,40650,1000,44500,0
pi4_r1-3_10-7500.csv,2,1687859224585,3.0,72200,57899,22200,5154351,17350,50000,1000,54850,0
pi4_r1-3_10-7500.csv,2,1687859225088,3.5,82500,65191,26200,5164651,20350,56300,1000,62150,0
pi4_r1-3_10-7500.csv,2,1687859225583,4.0,95800,76496,30200,5177951,22350,65600,1000,73450,0
pi4_r1-3_10-7500.csv,2,1687859226083,4.5,100000,76694,34200,5182151,26350,65800,1000,73650,0
pi4_r1-3_10-7500.csv,2,1687859226582,5.0,100000,72696,36200,5182151,30350,63800,1000,69650,0
pi4_r1-3_10-7500.csv,2,1687859227085,5.5,100000,69700,40200,5182151,34350,59800,1000,65650,0
pi4_r1-3_10-7500.csv,2,1687859227593,6.0,100000,64661,45200,5182151,38350,54800,1000,61650,0
pi4_r1-3_10-7500.csv,2,1687859228086,6.5,100000,61668,49200,5182151,42350,50800,1000,57650,0
pi4_r1-3_10-7500.csv,2,1687859228586,7.0,100000,56657,52200,5182151,46350,47800,1000,53650,0
pi4_r1-3_10-7500.csv,2,1687859229086,7.5,100000,53699,56200,5182151,50350,43800,1000,49650,0
pi4_r1-3_10-7500.csv,2,1687859229586,8.0,100000,48667,60200,5182151,54350,39800,1000,45650,0
pi4_r1-3_10-7500.csv,2,1687859230086,8.5,100000,44700,64200,5182151,58350,35800,1000,41650,0
pi4_r1-3_10-7500.csv,2,1687859230592,9.0,100000,41681,68200,5182151,61350,31800,1000,38650,0
pi4_r1-3_10-7500.csv,2,1687859231095,9.5,100000,38659,72200,5182151,65350,27800,1000,34650,0
pi4_r1-3_10-7500.csv,2,1687859231586,10.0,100000,35696,76200,5182151,69350,23800,1000,30650,0
pi4_r1-3_10-7500.csv,2,1687859232089,10.5,100000,29652,80200,5182151,73350,19800,1000,26650,0
pi4_r1-3_10-7500.csv,2,1687859232593,11.0,100000,25700,84200,5182151,77350,15800,1000,22650,0
pi4_r1-3_10-7500.csv,2,1687859233086,11.5,100000,21700,87200,5182151,81350,12800,1000,18650,0
pi4_r1-3_10-7500.csv,2,1687859233592,12.0,100000,18700,91200,5182151,85350,8800,1000,14650,0
pi4_r1-3_10-7500.csv,2,1687859234085,12.5,100000,14700,95200,5182151,89350,4800,1000,10650,0
pi4_r1-3_10-7500.csv,2,1687859234587,13.0,100000,9695,99200,5182151,93350,800,1000,6650,0
pi4_r1-3_10-7500.csv,2,1687859235087,13.5,100000,5678,100000,5182151,97350,0,1000,2650,0
pi4_r1-3_10-7500.csv,1,1687859203078,0.0,0,6,0,4982151,0,0,1000,0,0
pi4_r1-3_10-7500.csv,1,1687859203580,0.5,7400,7406,3350,4989551,3600,4050,1000,3800,0
pi4_r1-3_10-7500.csv,1,1687859204078,1.0,19300,19306,4350,5001451,3600,14950,1000,15700,0
pi4_r1-3_10-7500.csv,1,1687859204590,1.5,30500,30506,6350,5012651,4600,24150,1000,25900,0
pi4_r1-3_10-7500.csv,1,1687859205085,2.0,40850,37300,9350,5023001,6600,31500,1000,34250,0
pi4_r1-3_10-7500.csv,1,1687859205579,2.5,51450,44900,11350,5033601,9600,40100,1000,41850,0
pi4_r1-3_10-7500.csv,1,1687859206079,3.0,62650,52091,15350,5044801,13600,47300,1000,49050,0
pi4_r1-3_10-7500.csv,1,1687859206589,3.5,73200,59645,18350,5055351,16600,54850,1000,56600,0
pi4_r1-3_10-7500.csv,1,1687859207078,4.0,84100,68540,22350,5066251,19600,61750,1000,64500,0
pi4_r1-3_10-7500.csv,1,1687859207580,4.5,96000,75403,26350,5078151,23600,69650,1000,72400,0
pi4_r1-3_10-7500.csv,1,1687859208078,5.0,100000,75700,28350,5082151,27600,71650,1000,72400,0
pi4_r1-3_10-7500.csv,1,1687859208580,5.5,100000,71402,32350,5082151,31600,67650,1000,68400,0
pi4_r1-3_10-7500.csv,1,1687859209079,6.0,100000,69426,36350,5082151,34600,63650,1000,65400,0
pi4_r1-3_10-7500.csv,1,1687859209578,6.5,100000,65450,40350,5082151,37600,59650,1000,62400,0
pi4_r1-3_10-7500.csv,1,1687859210101,7.0,100000,61450,44350,5082151,41600,55650,1000,58400,0
pi4_r1-3_10-7500.csv,1,1687859210581,7.5,100000,57450,47350,5082151,45600,52650,1000,54400,0
pi4_r1-3_10-7500.csv,1,1687859211078,8.0,100000,53440,51350,5082151,49600,48650,1000,50400,0
pi4_r1-3_10-7500.csv,1,1687859211581,8.5,100000,49445,55350,5082151,53600,44650,1000,46400,0
pi4_r1-3_10-7500.csv,1,1687859212079,9.0,100000,45450,59350,5082151,57600,40650,1000,42400,0
pi4_r1-3_10-7500.csv,1,1687859212586,9.5,100000,41450,63350,5082151,61600,36650,1000,38400,0
pi4_r1-3_10-7500.csv,1,1687859213086,10.0,100000,37426,67350,5082151,65600,32650,1000,34400,0
pi4_r1-3_10-7500.csv,1,1687859213585,10.5,100000,33434,71350,5082151,69600,28650,1000,30400,0
pi4_r1-3_10-7500.csv,1,1687859214091,11.0,100000,29434,75350,5082151,73600,24650,1000,26400,0
pi4_r1-3_10-7500.csv,1,1687859214580,11.5,100000,25450,79350,5082151,77600,20650,1000,22400,0
pi4_r1-3_10-7500.csv,1,1687859215083,12.0,100000,23420,82350,5082151,80600,17650,1000,19400,0
pi4_r1-3_10-7500.csv,1,1687859215582,12.5,100000,18441,86350,5082151,84600,13650,1000,15400,0
pi4_r1-3_10-7500.csv,1,1687859216089,13.0,100000,14440,90350,5082151,88600,9650,1000,11400,0
pi4_r1-3_10-7500.csv,1,1687859216587,13.5,100000,10429,94350,5082151,92600,5650,1000,7400,0
pi4_r1-3_10-7500.csv,1,1687859217082,14.0,100000,7446,98350,5082151,96600,1650,1000,3400,0
pi4_r1-3_10-7500.csv,1,1687859217586,14.5,100000,4445,100000,5082151,98600,0,1000,1400,0
pi4_r1-3_10-7500.csv,3,1687858425209,0.0,0,49,0,4882151,0,0,100,0,0
pi4_r1-3_10-7500.csv,3,1687858425724,0.5,5300,4264,1600,4887451,1550,3700,100,3750,0
pi4_r1-3_10-7500.csv,3,1687858426211,1.0,15650,11903,4500,4897801,4150,11150,100,11500,0
pi4_r1-3_10-7500.csv,3,1687858426712,1.5,26850,20049,7600,4909001,7150,19250,100,19700,0
pi4_r1-3_10-7500.csv,3,1687858427212,2.0,38050,28244,10600,4920201,10250,27450,100,27800,0
pi4_r1-3_10-7500.csv,3,1687858427714,2.5,48400,35499,13700,4930551,13350,34700,100,35050,0
pi4_r1-3_10-7500.csv,3,1687858428213,3.0,59550,43518,16800,4941701,16450,42750,100,43100,0
pi4_r1-3_10-7500.csv,3,1687858428717,3.5,70600,51384,20100,4952751,19750,50500,100,50850,0
pi4_r1-3_10-7500.csv,3,1687858429216,4.0,81200,58785,23200,4963351,22850,58000,100,58350,0
pi4_r1-3_10-7500.csv,3,1687858429711,4.5,91350,66022,26100,4973501,25750,65250,100,65600,0
pi4_r1-3_10-7500.csv,3,1687858430209,5.0,100000,71800,28800,4982151,28650,71200,100,71350,0
pi4_r1-3_10-7500.csv,3,1687858430709,5.5,100000,68690,31900,4982151,31750,68100,100,68250,0
pi4_r1-3_10-7500.csv,3,1687858431213,6.0,100000,65477,35200,4982151,34950,64800,100,65050,0
pi4_r1-3_10-7500.csv,3,1687858431720,6.5,100000,62300,38300,4982151,38150,61700,100,61850,0
pi4_r1-3_10-7500.csv,3,1687858432213,7.0,100000,59156,41500,4982151,41350,58500,100,58650,0
pi4_r1-3_10-7500.csv,3,1687858432713,7.5,100000,55787,44700,4982151,44650,55300,100,55350,0
pi4_r1-3_10-7500.csv,3,1687858433213,8.0,100000,52600,47900,4982151,47850,52100,100,52150,0
pi4_r1-3_10-7500.csv,3,1687858433712,8.5,100000,49400,51100,4982151,51050,48900,100,48950,0
pi4_r1-3_10-7500.csv,3,1687858434214,9.0,100000,46199,54300,4982151,54250,45700,100,45750,0
pi4_r1-3_10-7500.csv,3,1687858434714,9.5,100000,42950,57500,4982151,57550,42500,100,42450,0
pi4_r1-3_10-7500.csv,3,1687858435222,10.0,100000,39724,60700,4982151,60850,39300,100,39150,0
pi4_r1-3_10-7500.csv,3,1687858435714,10.5,100000,36649,63800,4982151,64050,36200,100,35950,0
pi4_r1-3_10-7500.csv,3,1687858436216,11.0,100000,33443,67100,4982151,67250,32900,100,32750,0
pi4_r1-3_10-7500.csv,3,1687858436714,11.5,100000,30132,70300,4982151,70450,29700,100,29550,0
pi4_r1-3_10-7500.csv,3,1687858437217,12.0,100000,27317,73000,4982151,73350,27000,100,26650,0
pi4_r1-3_10-7500.csv,3,1687858437715,12.5,100000,25050,75400,4982151,76250,24600,100,23750,0
pi4_r1-3_10-7500.csv,3,1687858438214,13.0,100000,22150,78300,4982151,79550,21700,100,20450,0
pi4_r1-3_10-7500.csv,3,1687858438716,13.5,100000,19050,81400,4982151,82850,18600,100,17150,0
pi4_r1-3_10-7500.csv,3,1687858439215,14.0,100000,16250,84200,4982151,85250,15800,100,14750,0
pi4_r1-3_10-7500.csv,3,1687858439715,14.5,100000,13250,87200,4982151,88250,12800,100,11750,0
pi4_r1-3_10-7500.csv,3,1687858440217,15.0,100000,10350,90100,4982151,91350,9900,100,8650,0
pi4_r1-3_10-7500.csv,3,1687858440716,15.5,100000,7323,93100,4982151,94650,6900,100,5350,0
pi4_r1-3_10-7500.csv,3,1687858441217,16.0,100000,4323,96100,4982151,97950,3900,100,2050,0
pi4_r1-3_10-7500.csv,3,1687858441716,16.5,100000,1350,99100,4982151,100000,900,100,0,0
pi4_r1-3_10-7500.csv,2,1687858402703,0.0,0,50,0,4782151,0,0,100,0,0
pi4_r1-3_10-7500.csv,2,1687858403205,0.5,4450,3928,1250,4786601,1050,3200,100,3400,0
pi4_r1-3_10-7500.csv,2,1687858403704,1.0,16950,14112,4350,4799101,3150,12600,100,13800,0
pi4_r1-3_10-7500.csv,2,1687858404206,1.5,28500,23554,7350,4810651,5350,21150,100,23150,0
pi4_r1-3_10-7500.csv,2,1687858404705,2.0,40650,33615,10450,4822801,7450,30200,100,33200,0
pi4_r1-3_10-7500.csv,2,1687858405206,2.5,53100,43996,13550,4835251,9550,39550,100,43550,0
pi4_r1-3_10-7500.csv,2,1687858405710,3.0,66450,55111,16750,4848601,11850,49700,100,54600,0
pi4_r1-3_10-7500.csv,2,1687858406205,3.5,77800,64154,19850,4859951,14050,57950,100,63750,0
pi4_r1-3_10-7500.csv,2,1687858406710,4.0,90500,74583,22950,4872651,16350,67550,100,74150,0
pi4_r1-3_10-7500.csv,2,1687858407214,4.5,100000,82081,25850,4882151,18450,74150,100,81550,0
pi4_r1-3_10-7500.csv,2,1687858407707,5.0,100000,79353,28650,4882151,21150,71350,100,78850,0
pi4_r1-3_10-7500.csv,2,1687858408211,5.5,100000,76868,31850,4882151,24050,68150,100,75950,0
pi4_r1-3_10-7500.csv,2,1687858408707,6.0,100000,73600,34850,4882151,26850,65150,100,73150,0
pi4_r1-3_10-7500.csv,2,1687858409210,6.5,100000,70785,37950,4882151,29650,62050,100,70350,0
pi4_r1-3_10-7500.csv,2,1687858409707,7.0,100000,67681,41150,4882151,32650,58850,100,67350,0
pi4_r1-3_10-7500.csv,2,1687858410210,7.5,100000,64552,44450,4882151,35750,55550,100,64250,0
pi4_r1-3_10-7500.csv,2,1687858410707,8.0,100000,61795,47550,4882151,38750,52450,100,61250,0
pi4_r1-3_10-7500.csv,2,1687858411207,8.5,100000,58659,50750,4882151,41750,49250,100,58250,0
pi4_r1-3_10-7500.csv,2,1687858411712,9.0,100000,55688,54050,4882151,44850,45950,100,55150,0
pi4_r1-3_10-7500.csv,2,1687858412208,9.5,100000,52597,57250,4882151,47850,42750,100,52150,0
pi4_r1-3_10-7500.csv,2,1687858412709,10.0,100000,49572,60350,4882151,50850,39650,100,49150,0
pi4_r1-3_10-7500.csv,2,1687858413209,10.5,100000,46565,63550,4882151,53850,36450,100,46150,0
pi4_r1-3_10-7500.csv,2,1687858413709,11.0,100000,43600,66650,4882151,56850,33350,100,43150,0
pi4_r1-3_10-7500.csv,2,1687858414208,11.5,100000,40700,69850,4882151,59750,30150,100,40250,0
pi4_r1-3_10-7500.csv,2,1687858414710,12.0,100000,37796,72850,4882151,62650,27150,100,37350,0
pi4_r1-3_10-7500.csv,2,1687858415211,12.5,100000,35200,75950,4882151,65250,24050,100,34750,0
pi4_r1-3_10-7500.csv,2,1687858415711,13.0,100000,32395,78150,4882151,68050,21850,100,31950,0
pi4_r1-3_10-7500.csv,2,1687858416209,13.5,100000,29256,81250,4882151,71050,18750,100,28950,0
pi4_r1-3_10-7500.csv,2,1687858416710,14.0,100000,26255,84550,4882151,74150,15450,100,25850,0
pi4_r1-3_10-7500.csv,2,1687858417208,14.5,100000,23900,87650,4882151,76450,12350,100,23550,0
pi4_r1-3_10-7500.csv,2,1687858417710,15.0,100000,20856,90950,4882151,79550,9050,100,20450,0
pi4_r1-3_10-7500.csv,2,1687858418207,15.5,100000,17800,94050,4882151,82650,5950,100,17350,0
pi4_r1-3_10-7500.csv,2,1687858418708,16.0,100000,14796,97250,4882151,85650,2750,100,14350,0
pi4_r1-3_10-7500.csv,2,1687858419212,16.5,100000,11600,100000,4882151,88850,0,100,11150,0
pi4_r1-3_10-7500.csv,1,1687858375188,0.0,0,49,0,4682151,0,0,100,0,0
pi4_r1-3_10-7500.csv,1,1687858375689,0.5,7150,7199,800,4689301,1000,6350,100,6150,0
pi4_r1-3_10-7500.csv,1,1687858376189,1.0,18950,18600,1100,4701101,1700,17850,100,17250,0
pi4_r1-3_10-7500.csv,1,1687858376692,1.5,30500,28250,2800,4712651,2800,27700,100,27700,0
pi4_r1-3_10-7500.csv,1,1687858377194,2.0,41500,37850,4600,4723651,4100,36900,100,37400,0
pi4_r1-3_10-7500.csv,1,1687858377696,2.5,51750,45856,6600,4733901,6400,45150,100,45350,0
pi4_r1-3_10-7500.csv,1,1687858378192,3.0,63600,55650,8400,4745751,8600,55200,100,55000,0
pi4_r1-3_10-7500.csv,1,1687858378701,3.5,74550,65100,10000,4756701,10100,64550,100,64450,0
pi4_r1-3_10-7500.csv,1,1687858379193,4.0,84950,73067,12300,4767101,12300,72650,100,72650,0
pi4_r1-3_10-7500.csv,1,1687858379695,4.5,96750,82393,14900,4778901,15000,81850,100,81750,0
pi4_r1-3_10-7500.csv,1,1687858380193,5.0,100000,83150,17300,4782151,17600,82700,100,82400,0
pi4_r1-3_10-7500.csv,1,1687858380692,5.5,100000,80226,20200,4782151,20500,79800,100,79500,0
pi4_r1-3_10-7500.csv,1,1687858381197,6.0,100000,77532,23000,4782151,23400,77000,100,76600,0
pi4_r1-3_10-7500.csv,1,1687858381701,6.5,100000,74703,25800,4782151,26200,74200,100,73800,0
pi4_r1-3_10-7500.csv,1,1687858382193,7.0,100000,71950,28500,4782151,29000,71500,100,71000,0
pi4_r1-3_10-7500.csv,1,1687858382694,7.5,100000,69050,31400,4782151,31800,68600,100,68200,0
pi4_r1-3_10-7500.csv,1,1687858383192,8.0,100000,66849,34000,4782151,33700,66000,100,66300,0
pi4_r1-3_10-7500.csv,1,1687858383693,8.5,100000,63850,36900,4782151,36600,63100,100,63400,0
pi4_r1-3_10-7500.csv,1,1687858384198,9.0,100000,60850,39700,4782151,39700,60300,100,60300,0
pi4_r1-3_10-7500.csv,1,1687858384695,9.5,100000,58450,42400,4782151,42200,57600,100,57800,0
pi4_r1-3_10-7500.csv,1,1687858385193,10.0,100000,56026,44900,4782151,44400,55100,100,55600,0
pi4_r1-3_10-7500.csv,1,1687858385693,10.5,100000,53250,48000,4782151,47200,52000,100,52800,0
pi4_r1-3_10-7500.csv,1,1687858386193,11.0,100000,50550,51100,4782151,49900,48900,100,50100,0
pi4_r1-3_10-7500.csv,1,1687858386695,11.5,100000,48146,53300,4782151,52300,46700,100,47700,0
pi4_r1-3_10-7500.csv,1,1687858387195,12.0,100000,45345,56300,4782151,55100,43700,100,44900,0
pi4_r1-3_10-7500.csv,1,1687858387696,12.5,100000,42514,59200,4782151,57900,40800,100,42100,0
pi4_r1-3_10-7500.csv,1,1687858388194,13.0,100000,39528,62300,4782151,60900,37700,100,39100,0
pi4_r1-3_10-7500.csv,1,1687858388695,13.5,100000,36750,65400,4782151,63700,34600,100,36300,0
pi4_r1-3_10-7500.csv,1,1687858389195,14.0,100000,33729,68500,4782151,66700,31500,100,33300,0
pi4_r1-3_10-7500.csv,1,1687858389695,14.5,100000,30842,71700,4782151,69600,28300,100,30400,0
pi4_r1-3_10-7500.csv,1,1687858390197,15.0,100000,28019,74800,4782151,72500,25200,100,27500,0
pi4_r1-3_10-7500.csv,1,1687858390695,15.5,100000,25026,77900,4782151,75400,22100,100,24600,0
pi4_r1-3_10-7500.csv,1,1687858391197,16.0,100000,22114,81100,4782151,78300,18900,100,21700,0
pi4_r1-3_10-7500.csv,1,1687858391699,16.5,100000,19250,84300,4782151,81300,15700,100,18700,0
pi4_r1-3_10-7500.csv,1,1687858392197,17.0,100000,16547,87200,4782151,83800,12800,100,16200,0
pi4_r1-3_10-7500.csv,1,1687858392699,17.5,100000,14050,90100,4782151,86600,9900,100,13400,0
pi4_r1-3_10-7500.csv,1,1687858393199,18.0,100000,10732,93100,4782151,89700,6900,100,10300,0
pi4_r1-3_10-7500.csv,1,1687858393699,18.5,100000,7741,96100,4782151,92800,3900,100,7200,0
pi4_r1-3_10-7500.csv,1,1687858394198,19.0,100000,4425,99100,4782151,96000,900,100,4000,0
pi4_r1-3_10-7500.csv,1,1687858394697,19.5,100000,2546,100000,4782151,97900,0,100,2100,0
pi4_r1-3_10-7500.csv,3,1687854087274,0.0,0,413928,0,4582151,0,0,10,0,0
pi4_r1-3_10-7500.csv,3,1687854087780,0.5,2500,416428,190,4584651,210,2310,10,2290,0
pi4_r1-3_10-7500.csv,3,1687854088287,1.0,12300,426228,760,4594451,900,11540,10,11400,0
pi4_r1-3_10-7500.csv,3,1687854088785,1.5,19400,433328,1330,4601551,1490,18070,10,17910,0
pi4_r1-3_10-7500.csv,3,1687854089276,2.0,29900,443828,1720,4612051,2100,28180,10,27800,0
pi4_r1-3_10-7500.csv,3,1687854089779,2.5,41550,455478,2200,4623701,2870,39350,10,38680,0
pi4_r1-3_10-7500.csv,3,1687854090286,3.0,52250,466178,2710,4634401,3660,49540,10,48590,0
pi4_r1-3_10-7500.csv,3,1687854090774,3.5,62850,476778,3090,4645001,4360,59760,10,58490,0
pi4_r1-3_10-7500.csv,3,1687854091279,4.0,72550,486478,3790,4654701,5060,68760,10,67490,0
pi4_r1-3_10-7500.csv,3,1687854091780,4.5,83750,497678,4540,4665901,5900,79210,10,77850,0
pi4_r1-3_10-7500.csv,3,1687854092278,5.0,94700,508628,5180,4676851,6610,89520,10,88090,0
pi4_r1-3_10-7500.csv,3,1687854092778,5.5,100000,513928,5930,4682151,7140,94070,10,92860,0
pi4_r1-3_10-7500.csv,3,1687854093278,6.0,100000,513928,6820,4682151,7850,93180,10,92150,0
pi4_r1-3_10-7500.csv,3,1687854093779,6.5,100000,513928,7440,4682151,8620,92560,10,91380,0
pi4_r1-3_10-7500.csv,3,1687854094280,7.0,100000,513928,8220,4682151,9520,91780,10,90480,0
pi4_r1-3_10-7500.csv,3,1687854094783,7.5,100000,513928,8920,4682151,10250,91080,10,89750,0
pi4_r1-3_10-7500.csv,3,1687854095281,8.0,100000,513928,9660,4682151,11090,90340,10,88910,0
pi4_r1-3_10-7500.csv,3,1687854095778,8.5,100000,513928,10500,4682151,12020,89500,10,87980,0
pi4_r1-3_10-7500.csv,3,1687854096279,9.0,100000,513928,11440,4682151,12960,88560,10,87040,0
pi4_r1-3_10-7500.csv,3,1687854096778,9.5,100000,513928,12450,4682151,13860,87550,10,86140,0
pi4_r1-3_10-7500.csv,3,1687854097282,10.0,100000,513928,13480,4682151,14740,86520,10,85260,0
pi4_r1-3_10-7500.csv,3,1687854097779,10.5,100000,513928,14510,4682151,15650,85490,10,84350,0
pi4_r1-3_10-7500.csv,3,1687854098277,11.0,100000,513928,15540,4682151,16560,84460,10,83440,0
pi4_r1-3_10-7500.csv,3,1687854098783,11.5,100000,513928,16600,4682151,17480,83400,10,82520,0
pi4_r1-3_10-7500.csv,3,1687854099279,12.0,100000,513928,17620,4682151,18350,82380,10,81650,0
pi4_r1-3_10-7500.csv,3,1687854099783,12.5,100000,513928,18530,4682151,19120,81470,10,80880,0
pi4_r1-3_10-7500.csv,3,1687854100281,13.0,100000,513928,19360,4682151,19820,80640,10,80180,0
pi4_r1-3_10-7500.csv,3,1687854100787,13.5,100000,513928,20280,4682151,20610,79720,10,79390,0
pi4_r1-3_10-7500.csv,3,1687854101281,14.0,100000,513928,21120,4682151,21330,78880,10,78670,0
pi4_r1-3_10-7500.csv,3,1687854101781,14.5,100000,513928,22030,4682151,22050,77970,10,77950,0
pi4_r1-3_10-7500.csv,3,1687854102284,15.0,100000,513928,22870,4682151,22780,77130,10,77220,0
pi4_r1-3_10-7500.csv,3,1687854102781,15.5,100000,513928,23840,4682151,23540,76160,10,76460,0
pi4_r1-3_10-7500.csv,3,1687854103285,16.0,100000,513928,24860,4682151,24420,75140,10,75580,0
pi4_r1-3_10-7500.csv,3,1687854103786,16.5,100000,513928,25860,4682151,25300,74140,10,74700,0
pi4_r1-3_10-7500.csv,3,1687854104285,17.0,100000,513928,26840,4682151,26170,73160,10,73830,0
pi4_r1-3_10-7500.csv,3,1687854104784,17.5,100000,513928,27840,4682151,27070,72160,10,72930,0
pi4_r1-3_10-7500.csv,3,1687854105284,18.0,100000,513928,28820,4682151,27900,71180,10,72100,0
pi4_r1-3_10-7500.csv,3,1687854105787,18.5,100000,513928,29820,4682151,28800,70180,10,71200,0
pi4_r1-3_10-7500.csv,3,1687854106283,19.0,100000,513928,30810,4682151,29650,69190,10,70350,0
pi4_r1-3_10-7500.csv,3,1687854106783,19.5,100000,513928,31800,4682151,30530,68200,10,69470,0
pi4_r1-3_10-7500.csv,3,1687854107282,20.0,100000,513928,32800,4682151,31380,67200,10,68620,0
pi4_r1-3_10-7500.csv,3,1687854107785,20.5,100000,513928,33810,4682151,32190,66190,10,67810,0
pi4_r1-3_10-7500.csv,3,1687854108283,21.0,100000,513928,34810,4682151,33070,65190,10,66930,0
pi4_r1-3_10-7500.csv,3,1687854108785,21.5,100000,513928,35820,4682151,33940,64180,10,66060,0
pi4_r1-3_10-7500.csv,3,1687854109284,22.0,100000,513928,36810,4682151,34810,63190,10,65190,0
pi4_r1-3_10-7500.csv,3,1687854109786,22.5,100000,513928,37690,4682151,35460,62310,10,64540,0
pi4_r1-3_10-7500.csv,3,1687854110285,23.0,100000,513928,38310,4682151,36200,61690,10,63800,0
pi4_r1-3_10-7500.csv,3,1687854110787,23.5,100000,513928,39330,4682151,37070,60670,10,62930,0
pi4_r1-3_10-7500.csv,3,1687854111285,24.0,100000,513928,40340,4682151,37950,59660,10,62050,0
pi4_r1-3_10-7500.csv,3,1687854111783,24.5,100000,513928,41350,4682151,38810,58650,10,61190,0
pi4_r1-3_10-7500.csv,3,1687854112282,25.0,100000,513928,42280,4682151,39680,57720,10,60320,0
pi4_r1-3_10-7500.csv,3,1687854112784,25.5,100000,513928,43190,4682151,40610,56810,10,59390,0
pi4_r1-3_10-7500.csv,3,1687854113286,26.0,100000,513928,44130,4682151,41480,55870,10,58520,0
pi4_r1-3_10-7500.csv,3,1687854113785,26.5,100000,513928,45130,4682151,42270,54870,10,57730,0
pi4_r1-3_10-7500.csv,3,1687854114283,27.0,100000,513928,46140,4682151,43120,53860,10,56880,0
pi4_r1-3_10-7500.csv,3,1687854114785,27.5,100000,513928,47130,4682151,44010,52870,10,55990,0
pi4_r1-3_10-7500.csv,3,1687854115285,28.0,100000,513928,47910,4682151,44740,52090,10,55260,0
pi4_r1-3_10-7500.csv,3,1687854115785,28.5,100000,513928,48750,4682151,45630,51250,10,54370,0
pi4_r1-3_10-7500.csv,3,1687854116285,29.0,100000,513928,49620,4682151,46420,50380,10,53580,0
pi4_r1-3_10-7500.csv,3,1687854116784,29.5,100000,513928,50450,4682151,47110,49550,10,52890,0
pi4_r1-3_10-7500.csv,3,1687854117286,30.0,100000,513928,51180,4682151,47810,48820,10,52190,0
pi4_r1-3_10-7500.csv,3,1687854117787,30.5,100000,513928,52030,4682151,48630,47970,10,51370,0
pi4_r1-3_10-7500.csv,3,1687854118286,31.0,100000,513928,53010,4682151,49660,46990,10,50340,0
pi4_r1-3_10-7500.csv,3,1687854118786,31.5,100000,513928,54020,4682151,50680,45980,10,49320,0
pi4_r1-3_10-7500.csv,3,1687854119287,32.0,100000,513928,55000,4682151,51680,45000,10,48320,0
pi4_r1-3_10-7500.csv,3,1687854119788,32.5,100000,513928,56020,4682151,52640,43980,10,47360,0
pi4_r1-3_10-7500.csv,3,1687854120288,33.0,100000,513928,57020,4682151,53610,42980,10,46390,0
pi4_r1-3_10-7500.csv,3,1687854120790,33.5,100000,513928,57990,4682151,54620,42010,10,45380,0
pi4_r1-3_10-7500.csv,3,1687854121288,34.0,100000,513928,58980,4682151,55620,41020,10,44380,0
pi4_r1-3_10-7500.csv,3,1687854121787,34.5,100000,513928,60000,4682151,56650,40000,10,43350,0
pi4_r1-3_10-7500.csv,3,1687854122285,35.0,100000,513928,60930,4682151,57660,39070,10,42340,0
pi4_r1-3_10-7500.csv,3,1687854122787,35.5,100000,513928,61950,4682151,58690,38050,10,41310,0
pi4_r1-3_10-7500.csv,3,1687854123303,36.0,100000,513928,63000,4682151,59750,37000,10,40250,0
pi4_r1-3_10-7500.csv,3,1687854123788,36.5,100000,513928,64000,4682151,60750,36000,10,39250,0
pi4_r1-3_10-7500.csv,3,1687854124311,37.0,100000,513928,65040,4682151,61800,34960,10,38200,0
pi4_r1-3_10-7500.csv,3,1687854124790,37.5,100000,513928,65810,4682151,62610,34190,10,37390,0
pi4_r1-3_10-7500.csv,3,1687854125314,38.0,100000,513928,66800,4682151,63330,33200,10,36670,0
pi4_r1-3_10-7500.csv,3,1687854125787,38.5,100000,513928,67740,4682151,64020,32260,10,35980,0
pi4_r1-3_10-7500.csv,3,1687854126288,39.0,100000,513928,68730,4682151,65000,31270,10,35000,0
pi4_r1-3_10-7500.csv,3,1687854126789,39.5,100000,513928,69760,4682151,66020,30240,10,33980,0
pi4_r1-3_10-7500.csv,3,1687854127289,40.0,100000,513928,70780,4682151,67020,29220,10,32980,0
pi4_r1-3_10-7500.csv,3,1687854127789,40.5,100000,513928,71770,4682151,67910,28230,10,32090,0
pi4_r1-3_10-7500.csv,3,1687854128298,41.0,100000,513928,72790,4682151,68880,27210,10,31120,0
pi4_r1-3_10-7500.csv,3,1687854128795,41.5,100000,513928,73830,4682151,69910,26170,10,30090,0
pi4_r1-3_10-7500.csv,3,1687854129293,42.0,100000,513928,74820,4682151,70920,25180,10,29080,0
pi4_r1-3_10-7500.csv,3,1687854129791,42.5,100000,513928,75560,4682151,71760,24440,10,28240,0
pi4_r1-3_10-7500.csv,3,1687854130290,43.0,100000,513928,76420,4682151,72700,23580,10,27300,0
pi4_r1-3_10-7500.csv,3,1687854130792,43.5,100000,513928,77430,4682151,73710,22570,10,26290,0
pi4_r1-3_10-7500.csv,3,1687854131304,44.0,100000,513928,78450,4682151,74720,21550,10,25280,0
pi4_r1-3_10-7500.csv,3,1687854131792,44.5,100000,513928,79460,4682151,75740,20540,10,24260,0
pi4_r1-3_10-7500.csv,3,1687854132291,45.0,100000,513928,80330,4682151,76500,19670,10,23500,0
pi4_r1-3_10-7500.csv,3,1687854132793,45.5,100000,513928,81280,4682151,77440,18720,10,22560,0
pi4_r1-3_10-7500.csv,3,1687854133295,46.0,100000,513928,82300,4682151,78480,17700,10,21520,0
pi4_r1-3_10-7500.csv,3,1687854133794,46.5,100000,513928,83230,4682151,79470,16770,10,20530,0
pi4_r1-3_10-7500.csv,3,1687854134292,47.0,100000,513928,84230,4682151,80470,15770,10,19530,0
pi4_r1-3_10-7500.csv,3,1687854134794,47.5,100000,513928,85220,4682151,81480,14780,10,18520,0
pi4_r1-3_10-7500.csv,3,1687854135293,48.0,100000,513928,86210,4682151,82470,13790,10,17530,0
pi4_r1-3_10-7500.csv,3,1687854135793,48.5,100000,513928,87200,4682151,83470,12800,10,16530,0
pi4_r1-3_10-7500.csv,3,1687854136295,49.0,100000,513928,88200,4682151,84480,11800,10,15520,0
pi4_r1-3_10-7500.csv,3,1687854136793,49.5,100000,513928,89220,4682151,85500,10780,10,14500,0
pi4_r1-3_10-7500.csv,3,1687854137295,50.0,100000,513928,90260,4682151,86530,9740,10,13470,0
pi4_r1-3_10-7500.csv,3,1687854137795,50.5,100000,513928,91260,4682151,87530,8740,10,12470,0
pi4_r1-3_10-7500.csv,3,1687854138294,51.0,100000,513928,92140,4682151,88360,7860,10,11640,0
pi4_r1-3_10-7500.csv,3,1687854138796,51.5,100000,513928,93080,4682151,89190,6920,10,10810,0
pi4_r1-3_10-7500.csv,3,1687854139297,52.0,100000,513928,94070,4682151,90210,5930,10,9790,0
pi4_r1-3_10-7500.csv,3,1687854139800,52.5,100000,513928,94940,4682151,91030,5060,10,8970,0
pi4_r1-3_10-7500.csv,3,1687854140297,53.0,100000,513928,95760,4682151,91910,4240,10,8090,0
pi4_r1-3_10-7500.csv,3,1687854140794,53.5,100000,513928,96770,4682151,92910,3230,10,7090,0
pi4_r1-3_10-7500.csv,3,1687854141295,54.0,100000,513928,97770,4682151,93890,2230,10,6110,0
pi4_r1-3_10-7500.csv,3,1687854141798,54.5,100000,513928,98730,4682151,94840,1270,10,5160,0
pi4_r1-3_10-7500.csv,3,1687854142298,55.0,100000,513928,99710,4682151,95850,290,10,4150,0
pi4_r1-3_10-7500.csv,3,1687854142797,55.5,100000,513928,100000,4682151,96830,0,10,3170,0
pi4_r1-3_10-7500.csv,2,1687853860163,0.0,0,313928,0,4482151,0,0,10,0,0
pi4_r1-3_10-7500.csv,2,1687853860690,0.5,550,314478,80,4482701,70,470,10,480,0
pi4_r1-3_10-7500.csv,2,1687853861165,1.0,9000,322928,780,4491151,760,8220,10,8240,0
pi4_r1-3_10-7500.csv,2,1687853861669,1.5,16250,330178,1340,4498401,1230,14910,10,15020,0
pi4_r1-3_10-7500.csv,2,1687853862161,2.0,22200,336128,1770,4504351,1680,20430,10,20520,0
pi4_r1-3_10-7500.csv,2,1687853862659,2.5,31750,345678,2340,4513901,2170,29410,10,29580,0
pi4_r1-3_10-7500.csv,2,1687853863170,3.0,41900,355828,2980,4524051,2850,38920,10,39050,0
pi4_r1-3_10-7500.csv,2,1687853863663,3.5,49750,363678,3680,4531901,3470,46070,10,46280,0
pi4_r1-3_10-7500.csv,2,1687853864166,4.0,59450,373378,4380,4541601,4130,55070,10,55320,0
pi4_r1-3_10-7500.csv,2,1687853864660,4.5,68950,382878,5000,4551101,4750,63950,10,64200,0
pi4_r1-3_10-7500.csv,2,1687853865171,5.0,79400,393328,5510,4561551,5330,73890,10,74070,0
pi4_r1-3_10-7500.csv,2,1687853865696,5.5,89950,403878,6270,4572101,6030,83680,10,83920,0
pi4_r1-3_10-7500.csv,2,1687853866161,6.0,98750,412678,6910,4580901,6660,91840,10,92090,0
pi4_r1-3_10-7500.csv,2,1687853866783,6.6,100000,413928,7680,4582151,7560,92320,10,92440,0
pi4_r1-3_10-7500.csv,2,1687853867160,7.0,100000,413928,8280,4582151,7930,91720,10,92070,0
pi4_r1-3_10-7500.csv,2,1687853867791,7.6,100000,413928,9520,4582151,9000,90480,10,91000,0
pi4_r1-3_10-7500.csv,2,1687853868187,8.0,100000,413928,10310,4582151,9780,89690,10,90220,0
pi4_r1-3_10-7500.csv,2,1687853868843,8.7,100000,413928,11590,4582151,11050,88410,10,88950,0
pi4_r1-3_10-7500.csv,2,1687853869232,9.1,100000,413928,12330,4582151,11800,87670,10,88200,0
pi4_r1-3_10-7500.csv,2,1687853869887,9.7,100000,413928,13390,4582151,12830,86610,10,87170,0
pi4_r1-3_10-7500.csv,2,1687853870161,10.0,100000,413928,13930,4582151,13380,86070,10,86620,0
pi4_r1-3_10-7500.csv,2,1687853870663,10.5,100000,413928,14900,4582151,14340,85100,10,85660,0
pi4_r1-3_10-7500.csv,2,1687853871176,11.0,100000,413928,15880,4582151,15320,84120,10,84680,0
pi4_r1-3_10-7500.csv,2,1687853871664,11.5,100000,413928,16860,4582151,16280,83140,10,83720,0
pi4_r1-3_10-7500.csv,2,1687853872168,12.0,100000,413928,17870,4582151,17290,82130,10,82710,0
pi4_r1-3_10-7500.csv,2,1687853872666,12.5,100000,413928,18890,4582151,18310,81110,10,81690,0
pi4_r1-3_10-7500.csv,2,1687853873215,13.1,100000,413928,19980,4582151,19410,80020,10,80590,0
pi4_r1-3_10-7500.csv,2,1687853873672,13.5,100000,413928,20900,4582151,20330,79100,10,79670,0
pi4_r1-3_10-7500.csv,2,1687853874165,14.0,100000,413928,21880,4582151,21280,78120,10,78720,0
pi4_r1-3_10-7500.csv,2,1687853874670,14.5,100000,413928,22860,4582151,22230,77140,10,77770,0
pi4_r1-3_10-7500.csv,2,1687853875174,15.0,100000,413928,23890,4582151,23260,76110,10,76740,0
pi4_r1-3_10-7500.csv,2,1687853875675,15.5,100000,413928,24780,4582151,24260,75220,10,75740,0
pi4_r1-3_10-7500.csv,2,1687853876182,16.0,100000,413928,25800,4582151,25270,74200,10,74730,0
pi4_r1-3_10-7500.csv,2,1687853876672,16.5,100000,413928,26790,4582151,26270,73210,10,73730,0
pi4_r1-3_10-7500.csv,2,1687853877190,17.0,100000,413928,27730,4582151,27190,72270,10,72810,0
pi4_r1-3_10-7500.csv,2,1687853877673,17.5,100000,413928,28550,4582151,28040,71450,10,71960,0
pi4_r1-3_10-7500.csv,2,1687853878171,18.0,100000,413928,29540,4582151,29030,70460,10,70970,0
pi4_r1-3_10-7500.csv,2,1687853878670,18.5,100000,413928,30540,4582151,30000,69460,10,70000,0
pi4_r1-3_10-7500.csv,2,1687853879174,19.0,100000,413928,31570,4582151,31030,68430,10,68970,0
pi4_r1-3_10-7500.csv,2,1687853879672,19.5,100000,413928,32560,4582151,31990,67440,10,68010,0
pi4_r1-3_10-7500.csv,2,1687853880171,20.0,100000,413928,33480,4582151,32980,66520,10,67020,0
pi4_r1-3_10-7500.csv,2,1687853880671,20.5,100000,413928,34430,4582151,33970,65570,10,66030,0
pi4_r1-3_10-7500.csv,2,1687853881173,21.0,100000,413928,35440,4582151,34980,64560,10,65020,0
pi4_r1-3_10-7500.csv,2,1687853881673,21.5,100000,413928,36380,4582151,35970,63620,10,64030,0
pi4_r1-3_10-7500.csv,2,1687853882173,22.0,100000,413928,37310,4582151,36950,62690,10,63050,0
pi4_r1-3_10-7500.csv,2,1687853882677,22.5,100000,413928,38310,4582151,37950,61690,10,62050,0
pi4_r1-3_10-7500.csv,2,1687853883175,23.0,100000,413928,39310,4582151,38950,60690,10,61050,0
pi4_r1-3_10-7500.csv,2,1687853883676,23.5,100000,413928,40330,4582151,39960,59670,10,60040,0
pi4_r1-3_10-7500.csv,2,1687853884178,24.0,100000,413928,41320,4582151,40960,58680,10,59040,0
pi4_r1-3_10-7500.csv,2,1687853884686,24.5,100000,413928,42240,4582151,41880,57760,10,58120,0
pi4_r1-3_10-7500.csv,2,1687853885175,25.0,100000,413928,43040,4582151,42740,56960,10,57260,0
pi4_r1-3_10-7500.csv,2,1687853885676,25.5,100000,413928,44040,4582151,43740,55960,10,56260,0
pi4_r1-3_10-7500.csv,2,1687853886177,26.0,100000,413928,45070,4582151,44770,54930,10,55230,0
pi4_r1-3_10-7500.csv,2,1687853886678,26.5,100000,413928,46100,4582151,45800,53900,10,54200,0
pi4_r1-3_10-7500.csv,2,1687853887180,27.0,100000,413928,47090,4582151,46790,52910,10,53210,0
pi4_r1-3_10-7500.csv,2,1687853887677,27.5,100000,413928,47960,4582151,47450,52040,10,52550,0
pi4_r1-3_10-7500.csv,2,1687853888181,28.0,100000,413928,48860,4582151,48420,51140,10,51580,0
pi4_r1-3_10-7500.csv,2,1687853888680,28.5,100000,413928,49880,4582151,49460,50120,10,50540,0
pi4_r1-3_10-7500.csv,2,1687853889178,29.0,100000,413928,50890,4582151,50470,49110,10,49530,0
pi4_r1-3_10-7500.csv,2,1687853889677,29.5,100000,413928,51890,4582151,51470,48110,10,48530,0
pi4_r1-3_10-7500.csv,2,1687853890178,30.0,100000,413928,52890,4582151,52490,47110,10,47510,0
pi4_r1-3_10-7500.csv,2,1687853890680,30.5,100000,413928,53860,4582151,53490,46140,10,46510,0
pi4_r1-3_10-7500.csv,2,1687853891183,31.0,100000,413928,54880,4582151,54530,45120,10,45470,0
pi4_r1-3_10-7500.csv,2,1687853891680,31.5,100000,413928,55880,4582151,55540,44120,10,44460,0
pi4_r1-3_10-7500.csv,2,1687853892188,32.0,100000,413928,56730,4582151,56410,43270,10,43590,0
pi4_r1-3_10-7500.csv,2,1687853892676,32.5,100000,413928,57540,4582151,57260,42460,10,42740,0
pi4_r1-3_10-7500.csv,2,1687853893176,33.0,100000,413928,58410,4582151,58260,41590,10,41740,0
pi4_r1-3_10-7500.csv,2,1687853893681,33.5,100000,413928,59360,4582151,59290,40640,10,40710,0
pi4_r1-3_10-7500.csv,2,1687853894177,34.0,100000,413928,60370,4582151,60300,39630,10,39700,0
pi4_r1-3_10-7500.csv,2,1687853894678,34.5,100000,413928,61380,4582151,61320,38620,10,38680,0
pi4_r1-3_10-7500.csv,2,1687853895180,35.0,100000,413928,62380,4582151,62330,37620,10,37670,0
pi4_r1-3_10-7500.csv,2,1687853895679,35.5,100000,413928,63380,4582151,63330,36620,10,36670,0
pi4_r1-3_10-7500.csv,2,1687853896181,36.0,100000,413928,64410,4582151,64370,35590,10,35630,0
pi4_r1-3_10-7500.csv,2,1687853896679,36.5,100000,413928,65410,4582151,65370,34590,10,34630,0
pi4_r1-3_10-7500.csv,2,1687853897180,37.0,100000,413928,66400,4582151,66360,33600,10,33640,0
pi4_r1-3_10-7500.csv,2,1687853897680,37.5,100000,413928,67440,4582151,67400,32560,10,32600,0
pi4_r1-3_10-7500.csv,2,1687853898181,38.0,100000,413928,68450,4582151,68420,31550,10,31580,0
pi4_r1-3_10-7500.csv,2,1687853898683,38.5,100000,413928,69320,4582151,69390,30680,10,30610,0
pi4_r1-3_10-7500.csv,2,1687853899179,39.0,100000,413928,70210,4582151,70350,29790,10,29650,0
pi4_r1-3_10-7500.csv,2,1687853899692,39.5,100000,413928,71070,4582151,71190,28930,10,28810,0
pi4_r1-3_10-7500.csv,2,1687853900182,40.0,100000,413928,71890,4582151,71990,28110,10,28010,0
pi4_r1-3_10-7500.csv,2,1687853900681,40.5,100000,413928,72720,4582151,72910,27280,10,27090,0
pi4_r1-3_10-7500.csv,2,1687853901182,41.0,100000,413928,73470,4582151,73840,26530,10,26160,0
pi4_r1-3_10-7500.csv,2,1687853901684,41.5,100000,413928,74410,4582151,74830,25590,10,25170,0
pi4_r1-3_10-7500.csv,2,1687853902184,42.0,100000,413928,75420,4582151,75840,24580,10,24160,0
pi4_r1-3_10-7500.csv,2,1687853902686,42.5,100000,413928,76420,4582151,76840,23580,10,23160,0
pi4_r1-3_10-7500.csv,2,1687853903185,43.0,100000,413928,77360,4582151,77840,22640,10,22160,0
pi4_r1-3_10-7500.csv,2,1687853903686,43.5,100000,413928,78350,4582151,78830,21650,10,21170,0
pi4_r1-3_10-7500.csv,2,1687853904187,44.0,100000,413928,79380,4582151,79830,20620,10,20170,0
pi4_r1-3_10-7500.csv,2,1687853904687,44.5,100000,413928,80390,4582151,80750,19610,10,19250,0
pi4_r1-3_10-7500.csv,2,1687853905188,45.0,100000,413928,81400,4582151,81780,18600,10,18220,0
pi4_r1-3_10-7500.csv,2,1687853905691,45.5,100000,413928,82440,4582151,82810,17560,10,17190,0
pi4_r1-3_10-7500.csv,2,1687853906188,46.0,100000,413928,83390,4582151,83760,16610,10,16240,0
pi4_r1-3_10-7500.csv,2,1687853906689,46.5,100000,413928,84420,4582151,84790,15580,10,15210,0
pi4_r1-3_10-7500.csv,2,1687853907189,47.0,100000,413928,85290,4582151,85670,14710,10,14330,0
pi4_r1-3_10-7500.csv,2,1687853907690,47.5,100000,413928,86100,4582151,86550,13900,10,13450,0
pi4_r1-3_10-7500.csv,2,1687853908191,48.0,100000,413928,87100,4582151,87460,12900,10,12540,0
pi4_r1-3_10-7500.csv,2,1687853908699,48.5,100000,413928,88110,4582151,88390,11890,10,11610,0
pi4_r1-3_10-7500.csv,2,1687853909187,49.0,100000,413928,89070,4582151,89270,10930,10,10730,0
pi4_r1-3_10-7500.csv,2,1687853909690,49.5,100000,413928,90080,4582151,90210,9920,10,9790,0
pi4_r1-3_10-7500.csv,2,1687853910189,50.0,100000,413928,91100,4582151,91230,8900,10,8770,0
pi4_r1-3_10-7500.csv,2,1687853910689,50.5,100000,413928,92080,4582151,92220,7920,10,7780,0
pi4_r1-3_10-7500.csv,2,1687853911191,51.0,100000,413928,93100,4582151,93160,6900,10,6840,0
pi4_r1-3_10-7500.csv,2,1687853911693,51.5,100000,413928,94140,4582151,94200,5860,10,5800,0
pi4_r1-3_10-7500.csv,2,1687853912191,52.0,100000,413928,95160,4582151,95220,4840,10,4780,0
pi4_r1-3_10-7500.csv,2,1687853912689,52.5,100000,413928,96180,4582151,96240,3820,10,3760,0
pi4_r1-3_10-7500.csv,2,1687853913190,53.0,100000,413928,97200,4582151,97250,2800,10,2750,0
pi4_r1-3_10-7500.csv,2,1687853913690,53.5,100000,413928,98220,4582151,98270,1780,10,1730,0
pi4_r1-3_10-7500.csv,2,1687853914189,54.0,100000,413928,99240,4582151,99290,760,10,710,0
pi4_r1-3_10-7500.csv,1,1687853665046,0.0,0,213928,0,4382151,0,0,10,0,0
pi4_r1-3_10-7500.csv,1,1687853665559,0.5,2400,216328,80,4384551,110,2320,10,2290,0
pi4_r1-3_10-7500.csv,1,1687853666067,1.0,12450,226378,300,4394601,420,12150,10,12030,0
pi4_r1-3_10-7500.csv,1,1687853666552,1.5,22750,236678,540,4404901,810,22210,10,21940,0
pi4_r1-3_10-7500.csv,1,1687853667057,2.0,32700,246628,840,4414851,1140,31860,10,31560,0
pi4_r1-3_10-7500.csv,1,1687853667547,2.5,42300,256228,1110,4424451,1370,41190,10,40930,0
pi4_r1-3_10-7500.csv,1,1687853668051,3.0,52400,266328,1450,4434551,1800,50950,10,50600,0
pi4_r1-3_10-7500.csv,1,1687853668549,3.5,63000,276928,1800,4445151,2310,61200,10,60690,0
pi4_r1-3_10-7500.csv,1,1687853669055,4.0,73300,287228,2190,4455451,2890,71110,10,70410,0
pi4_r1-3_10-7500.csv,1,1687853669549,4.5,84200,298128,2490,4466351,3170,81710,10,81030,0
pi4_r1-3_10-7500.csv,1,1687853670046,5.0,96300,310228,2710,4478451,3620,93590,10,92680,0
pi4_r1-3_10-7500.csv,1,1687853670550,5.5,100000,313928,3110,4482151,4230,96890,10,95770,0
pi4_r1-3_10-7500.csv,1,1687853671049,6.0,100000,313928,3690,4482151,4970,96310,10,95030,0
pi4_r1-3_10-7500.csv,1,1687853671549,6.5,100000,313928,4350,4482151,5750,95650,10,94250,0
pi4_r1-3_10-7500.csv,1,1687853672048,7.0,100000,313928,5100,4482151,6640,94900,10,93360,0
pi4_r1-3_10-7500.csv,1,1687853672549,7.5,100000,313928,5770,4482151,7450,94230,10,92550,0
pi4_r1-3_10-7500.csv,1,1687853673057,8.0,100000,313928,6540,4482151,8310,93460,10,91690,0
pi4_r1-3_10-7500.csv,1,1687853673550,8.5,100000,313928,7270,4482151,9210,92730,10,90790,0
pi4_r1-3_10-7500.csv,1,1687853674051,9.0,100000,313928,7950,4482151,10140,92050,10,89860,0
pi4_r1-3_10-7500.csv,1,1687853674550,9.5,100000,313928,8610,4482151,10820,91390,10,89180,0
pi4_r1-3_10-7500.csv,1,1687853675048,10.0,100000,313928,9230,4482151,11370,90770,10,88630,0
pi4_r1-3_10-7500.csv,1,1687853675548,10.5,100000,313928,10060,4482151,12260,89940,10,87740,0
pi4_r1-3_10-7500.csv,1,1687853676054,11.0,100000,313928,10910,4482151,13200,89090,10,86800,0
pi4_r1-3_10-7500.csv,1,1687853676550,11.5,100000,313928,11860,4482151,14190,88140,10,85810,0
pi4_r1-3_10-7500.csv,1,1687853677049,12.0,100000,313928,12780,4482151,15150,87220,10,84850,0
pi4_r1-3_10-7500.csv,1,1687853677896,12.9,100000,313928,14430,4482151,16840,85570,10,83160,0
pi4_r1-3_10-7500.csv,1,1687853678047,13.0,100000,313928,14730,4482151,17140,85270,10,82860,0
pi4_r1-3_10-7500.csv,1,1687853678551,13.5,100000,313928,15700,4482151,18120,84300,10,81880,0
pi4_r1-3_10-7500.csv,1,1687853679052,14.0,100000,313928,16690,4482151,19120,83310,10,80880,0
pi4_r1-3_10-7500.csv,1,1687853679553,14.5,100000,313928,17480,4482151,19980,82520,10,80020,0
pi4_r1-3_10-7500.csv,1,1687853680050,15.0,100000,313928,18010,4482151,20690,81990,10,79310,0
pi4_r1-3_10-7500.csv,1,1687853680551,15.5,100000,313928,18730,4482151,21560,81270,10,78440,0
pi4_r1-3_10-7500.csv,1,1687853681052,16.0,100000,313928,19710,4482151,22540,80290,10,77460,0
pi4_r1-3_10-7500.csv,1,1687853681550,16.5,100000,313928,20650,4482151,23520,79350,10,76480,0
pi4_r1-3_10-7500.csv,1,1687853682062,17.0,100000,313928,21540,4482151,24420,78460,10,75580,0
pi4_r1-3_10-7500.csv,1,1687853682550,17.5,100000,313928,22260,4482151,25120,77740,10,74880,0
pi4_r1-3_10-7500.csv,1,1687853683067,18.0,100000,313928,23250,4482151,26110,76750,10,73890,0
pi4_r1-3_10-7500.csv,1,1687853683593,18.5,100000,313928,24300,4482151,27170,75700,10,72830,0
pi4_r1-3_10-7500.csv,1,1687853684129,19.1,100000,313928,25410,4482151,28270,74590,10,71730,0
pi4_r1-3_10-7500.csv,1,1687853684641,19.6,100000,313928,26380,4482151,29240,73620,10,70760,0
pi4_r1-3_10-7500.csv,1,1687853685050,20.0,100000,313928,27050,4482151,30050,72950,10,69950,0
pi4_r1-3_10-7500.csv,1,1687853685557,20.5,100000,313928,27880,4482151,31030,72120,10,68970,0
pi4_r1-3_10-7500.csv,1,1687853686086,21.0,100000,313928,28930,4482151,32090,71070,10,67910,0
pi4_r1-3_10-7500.csv,1,1687853686606,21.6,100000,313928,29870,4482151,32720,70130,10,67280,0
pi4_r1-3_10-7500.csv,1,1687853687129,22.1,100000,313928,30930,4482151,33790,69070,10,66210,0
pi4_r1-3_10-7500.csv,1,1687853687553,22.5,100000,313928,31780,4482151,34600,68220,10,65400,0
pi4_r1-3_10-7500.csv,1,1687853688054,23.0,100000,313928,32790,4482151,35610,67210,10,64390,0
pi4_r1-3_10-7500.csv,1,1687853688555,23.5,100000,313928,33800,4482151,36630,66200,10,63370,0
pi4_r1-3_10-7500.csv,1,1687853689060,24.0,100000,313928,34810,4482151,37640,65190,10,62360,0
pi4_r1-3_10-7500.csv,1,1687853689564,24.5,100000,313928,35690,4482151,38410,64310,10,61590,0
pi4_r1-3_10-7500.csv,1,1687853690058,25.0,100000,313928,36450,4482151,39230,63550,10,60770,0
pi4_r1-3_10-7500.csv,1,1687853690556,25.5,100000,313928,37450,4482151,40230,62550,10,59770,0
pi4_r1-3_10-7500.csv,1,1687853691057,26.0,100000,313928,38470,4482151,41240,61530,10,58760,0
pi4_r1-3_10-7500.csv,1,1687853691557,26.5,100000,313928,39130,4482151,42120,60870,10,57880,0
pi4_r1-3_10-7500.csv,1,1687853692056,27.0,100000,313928,40130,4482151,43110,59870,10,56890,0
pi4_r1-3_10-7500.csv,1,1687853692559,27.5,100000,313928,41140,4482151,44000,58860,10,56000,0
pi4_r1-3_10-7500.csv,1,1687853693055,28.0,100000,313928,42130,4482151,44870,57870,10,55130,0
pi4_r1-3_10-7500.csv,1,1687853693564,28.5,100000,313928,43120,4482151,45770,56880,10,54230,0
pi4_r1-3_10-7500.csv,1,1687853694077,29.0,100000,313928,44130,4482151,46680,55870,10,53320,0
pi4_r1-3_10-7500.csv,1,1687853694558,29.5,100000,313928,45080,4482151,47580,54920,10,52420,0
pi4_r1-3_10-7500.csv,1,1687853695142,30.1,100000,313928,46230,4482151,48680,53770,10,51320,0
pi4_r1-3_10-7500.csv,1,1687853695559,30.5,100000,313928,47040,4482151,49500,52960,10,50500,0
pi4_r1-3_10-7500.csv,1,1687853696175,31.1,100000,313928,48160,4482151,50350,51840,10,49650,0
pi4_r1-3_10-7500.csv,1,1687853696569,31.5,100000,313928,48940,4482151,51060,51060,10,48940,0
pi4_r1-3_10-7500.csv,1,1687853697056,32.0,100000,313928,49880,4482151,51990,50120,10,48010,0
pi4_r1-3_10-7500.csv,1,1687853697559,32.5,100000,313928,50570,4482151,52840,49430,10,47160,0
pi4_r1-3_10-7500.csv,1,1687853698062,33.0,100000,313928,51580,4482151,53870,48420,10,46130,0
pi4_r1-3_10-7500.csv,1,1687853698558,33.5,100000,313928,52560,4482151,54890,47440,10,45110,0
pi4_r1-3_10-7500.csv,1,1687853699061,34.0,100000,313928,53560,4482151,55910,46440,10,44090,0
pi4_r1-3_10-7500.csv,1,1687853699560,34.5,100000,313928,54530,4482151,56900,45470,10,43100,0
pi4_r1-3_10-7500.csv,1,1687853700060,35.0,100000,313928,55470,4482151,57870,44530,10,42130,0
pi4_r1-3_10-7500.csv,1,1687853700559,35.5,100000,313928,56460,4482151,58870,43540,10,41130,0
pi4_r1-3_10-7500.csv,1,1687853701064,36.0,100000,313928,57460,4482151,59880,42540,10,40120,0
pi4_r1-3_10-7500.csv,1,1687853701560,36.5,100000,313928,58420,4482151,60870,41580,10,39130,0
pi4_r1-3_10-7500.csv,1,1687853702061,37.0,100000,313928,59380,4482151,61870,40620,10,38130,0
pi4_r1-3_10-7500.csv,1,1687853702561,37.5,100000,313928,60040,4482151,62780,39960,10,37220,0
pi4_r1-3_10-7500.csv,1,1687853703060,38.0,100000,313928,61050,4482151,63770,38950,10,36230,0
pi4_r1-3_10-7500.csv,1,1687853703561,38.5,100000,313928,62060,4482151,64710,37940,10,35290,0
pi4_r1-3_10-7500.csv,1,1687853704060,39.0,100000,313928,63070,4482151,65730,36930,10,34270,0
pi4_r1-3_10-7500.csv,1,1687853704562,39.5,100000,313928,64050,4482151,66720,35950,10,33280,0
pi4_r1-3_10-7500.csv,1,1687853705059,40.0,100000,313928,64770,4482151,67390,35230,10,32610,0
pi4_r1-3_10-7500.csv,1,1687853705560,40.5,100000,313928,65680,4482151,68270,34320,10,31730,0
pi4_r1-3_10-7500.csv,1,1687853706062,41.0,100000,313928,66640,4482151,69250,33360,10,30750,0
pi4_r1-3_10-7500.csv,1,1687853706563,41.5,100000,313928,67610,4482151,70190,32390,10,29810,0
pi4_r1-3_10-7500.csv,1,1687853707065,42.0,100000,313928,68630,4482151,71200,31370,10,28800,0
pi4_r1-3_10-7500.csv,1,1687853707563,42.5,100000,313928,69590,4482151,72160,30410,10,27840,0
pi4_r1-3_10-7500.csv,1,1687853708062,43.0,100000,313928,70430,4482151,73190,29570,10,26810,0
pi4_r1-3_10-7500.csv,1,1687853708562,43.5,100000,313928,71310,4482151,74170,28690,10,25830,0
pi4_r1-3_10-7500.csv,1,1687853709063,44.0,100000,313928,72220,4482151,75170,27780,10,24830,0
pi4_r1-3_10-7500.csv,1,1687853709574,44.5,100000,313928,73120,4482151,76180,26880,10,23820,0
pi4_r1-3_10-7500.csv,1,1687853710064,45.0,100000,313928,73870,4482151,76880,26130,10,23120,0
pi4_r1-3_10-7500.csv,1,1687853710566,45.5,100000,313928,74750,4482151,77870,25250,10,22130,0
pi4_r1-3_10-7500.csv,1,1687853711064,46.0,100000,313928,75610,4482151,78770,24390,10,21230,0
pi4_r1-3_10-7500.csv,1,1687853711565,46.5,100000,313928,76530,4482151,79680,23470,10,20320,0
pi4_r1-3_10-7500.csv,1,1687853712065,47.0,100000,313928,77390,4482151,80570,22610,10,19430,0
pi4_r1-3_10-7500.csv,1,1687853712563,47.5,100000,313928,78070,4482151,81290,21930,10,18710,0
pi4_r1-3_10-7500.csv,1,1687853713070,48.0,100000,313928,78920,4482151,82240,21080,10,17760,0
pi4_r1-3_10-7500.csv,1,1687853713566,48.5,100000,313928,79920,4482151,83250,20080,10,16750,0
pi4_r1-3_10-7500.csv,1,1687853714065,49.0,100000,313928,80890,4482151,84240,19110,10,15760,0
pi4_r1-3_10-7500.csv,1,1687853714567,49.5,100000,313928,81830,4482151,85210,18170,10,14790,0
pi4_r1-3_10-7500.csv,1,1687853715070,50.0,100000,313928,82860,4482151,86250,17140,10,13750,0
pi4_r1-3_10-7500.csv,1,1687853715568,50.5,100000,313928,83810,4482151,87260,16190,10,12740,0
pi4_r1-3_10-7500.csv,1,1687853716069,51.0,100000,313928,84760,4482151,88270,15240,10,11730,0
pi4_r1-3_10-7500.csv,1,1687853716569,51.5,100000,313928,85740,4482151,89270,14260,10,10730,0
pi4_r1-3_10-7500.csv,1,1687853717069,52.0,100000,313928,86710,4482151,90270,13290,10,9730,0
pi4_r1-3_10-7500.csv,1,1687853717573,52.5,100000,313928,87720,4482151,91290,12280,10,8710,0
pi4_r1-3_10-7500.csv,1,1687853718068,53.0,100000,313928,88700,4482151,92280,11300,10,7720,0
pi4_r1-3_10-7500.csv,1,1687853718572,53.5,100000,313928,89710,4482151,93300,10290,10,6700,0
pi4_r1-3_10-7500.csv,1,1687853719071,54.0,100000,313928,90700,4482151,94310,9300,10,5690,0
pi4_r1-3_10-7500.csv,1,1687853719583,54.5,100000,313928,91640,4482151,95260,8360,10,4740,0
pi4_r1-3_10-7500.csv,1,1687853720072,55.0,100000,313928,92460,4482151,95900,7540,10,4100,0
pi4_r1-3_10-7500.csv,1,1687853720570,55.5,100000,313928,93460,4482151,96730,6540,10,3270,0
pi4_r1-3_10-7500.csv,1,1687853721071,56.0,100000,313928,94460,4482151,97590,5540,10,2410,0
pi4_r1-3_10-7500.csv,1,1687853721570,56.5,100000,313928,95450,4482151,98450,4550,10,1550,0
pi4_r1-3_10-7500.csv,1,1687853722070,57.0,100000,313928,96450,4482151,99300,3550,10,700,0
pi4_r1-3_10-7500.csv,1,1687853722571,57.5,100000,313928,97440,4482151,100000,2560,10,0,0
pi4_r1-3_10-7500.csv,1,1687853723071,58.0,100000,313928,98450,4482151,100000,1550,10,0,0
pi4_r1-3_10-7500.csv,1,1687853723573,58.5,100000,313928,99420,4482151,100000,580,10,0,0
